athlete,age,country,year,sport,"Gold Medals","Silver Medals","Bronze Medals","Total Medals"
"Michael Phelps",23,"United States",2008,Swimming,8,0,0,8
"Natalie Coughlin",25,"United States",2008,Swimming,1,2,3,6
"Nastia Liukin",18,"United States",2008,Gymnastics,1,3,1,5
"Kirsty Coventry",24,Zimbabwe,2008,Swimming,1,3,0,4
"Libby Lenton-Trickett",23,Australia,2008,Swimming,2,1,1,4
"Ryan Lochte",24,"United States",2008,Swimming,2,0,2,4
"Shawn Johnson",16,"United States",2008,Gymnastics,1,3,0,4
"Alain Bernard",25,France,2008,Swimming,1,1,1,3
"László Cseh Jr.",22,Hungary,2008,Swimming,0,3,0,3
"Matt Grevers",23,"United States",2008,Swimming,2,1,0,3
"Margaret Hoelzer",25,"United States",2008,Swimming,0,2,1,3
"Katie Hoff",19,"United States",2008,Swimming,0,1,2,3
"Leisel Jones",22,Australia,2008,Swimming,2,1,0,3
"Kosuke Kitajima",25,Japan,2008,Swimming,2,0,1,3
"Andrew Lauterstein",21,Australia,2008,Swimming,0,1,2,3
"Jason Lezak",32,"United States",2008,Swimming,2,0,1,3
"Pang Jiaying",23,China,2008,Swimming,0,1,2,3
"Aaron Peirsol",25,"United States",2008,Swimming,2,1,0,3
"Steph Rice",20,Australia,2008,Swimming,3,0,0,3
"Jess Schipper",21,Australia,2008,Swimming,1,0,2,3
"Rebecca Soni",21,"United States",2008,Swimming,1,2,0,3
"Eamon Sullivan",22,Australia,2008,Swimming,0,2,1,3
"Dara Torres",41,"United States",2008,Swimming,0,3,0,3
"Cheng Fei",20,China,2008,Gymnastics,1,0,2,3
"Yang Wei",28,China,2008,Gymnastics,2,1,0,3
"Yang Yilin",15,China,2008,Gymnastics,1,0,2,3
"Zou Kai",20,China,2008,Gymnastics,3,0,0,3
"Chris Hoy",32,"Great Britain",2008,Cycling,3,0,0,3
"Usain Bolt",21,Jamaica,2008,Athletics,3,0,0,3
"Guo Yue",20,China,2008,"Table Tennis",1,0,1,2
"Ma Lin",28,China,2008,"Table Tennis",2,0,0,2
"Wang Hao",24,China,2008,"Table Tennis",1,1,0,2
"Wang Liqin",30,China,2008,"Table Tennis",1,0,1,2
"Wang Nan",29,China,2008,"Table Tennis",1,1,0,2
"Zhang Yining",26,China,2008,"Table Tennis",2,0,0,2
"Anastasiya Davydova",25,Russia,2008,"Synchronized Swimming",2,0,0,2
"Andrea Fuentes",25,Spain,2008,"Synchronized Swimming",0,2,0,2
"Gemma Mengual",31,Spain,2008,"Synchronized Swimming",0,2,0,2
"Anastasiya Yermakova",25,Russia,2008,"Synchronized Swimming",2,0,0,2
"Becky Adlington",19,"Great Britain",2008,Swimming,2,0,0,2
"Leith Brodie",22,Australia,2008,Swimming,0,0,2,2
"Cate Campbell",16,Australia,2008,Swimming,0,0,2,2
"César Cielo Filho",21,Brazil,2008,Swimming,1,0,1,2
"Hugues Duboscq",26,France,2008,Swimming,0,0,2,2
"Felicity Galvez",23,Australia,2008,Swimming,2,0,0,2
"Grant Hackett",28,Australia,2008,Swimming,0,1,1,2
"Kara Lynn Joyce",22,"United States",2008,Swimming,0,2,0,2
"Amaury Leveaux",22,France,2008,Swimming,0,2,0,2
"Christine Magnuson",22,"United States",2008,Swimming,0,2,0,2
"Patrick Murphy",24,Australia,2008,Swimming,0,0,2,2
"Park Tae-Hwan",18,"South Korea",2008,Swimming,1,1,0,2
"Shayne Reese",25,Australia,2008,Swimming,1,0,1,2
"Brenton Rickard",24,Australia,2008,Swimming,0,2,0,2
"Mel Schlanger",21,Australia,2008,Swimming,1,0,1,2
"Julia Smit",20,"United States",2008,Swimming,0,1,1,2
"Britta Steffen",24,Germany,2008,Swimming,2,0,0,2
"Hayden Stoeckel",24,Australia,2008,Swimming,0,1,1,2
"Matt Targett",22,Australia,2008,Swimming,0,1,1,2
"Peter Vanderkaay",24,"United States",2008,Swimming,1,0,1,2
"Arkady Vyachanin",24,Russia,2008,Swimming,0,0,2,2
"Garrett Weber-Gale",23,"United States",2008,Swimming,2,0,0,2
"Jin Jong-O",28,"South Korea",2008,Shooting,1,1,0,2
"Katerina Kurková-Emmons",24,"Czech Republic",2008,Shooting,1,1,0,2
"Georgeta Damian-Andrunache",32,Romania,2008,Rowing,1,0,1,2
"Viorica Susanu",32,Romania,2008,Rowing,1,0,1,2
"Chen Yibing",23,China,2008,Gymnastics,2,0,0,2
"Anton Golotsutskov",23,Russia,2008,Gymnastics,0,0,2,2
"He Kexin",16,China,2008,Gymnastics,2,0,0,2
"Jonathan Horton",22,"United States",2008,Gymnastics,0,1,1,2
"Sandra Izbasa",18,Romania,2008,Gymnastics,1,0,1,2
"Li Xiaopeng",27,China,2008,Gymnastics,2,0,0,2
"Kohei Uchimura",19,Japan,2008,Gymnastics,0,2,0,2
"Xiao Qin",23,China,2008,Gymnastics,2,0,0,2
"Stefano Carozzo",29,Italy,2008,Fencing,0,0,2,2
"Margherita Granbassi",28,Italy,2008,Fencing,0,0,2,2
"Sada Jacobson",25,"United States",2008,Fencing,0,1,1,2
"Fabrice Jeannet",27,France,2008,Fencing,1,1,0,2
"Nicolas Lopez",27,France,2008,Fencing,1,1,0,2
"Matteo Tagliariol",25,Italy,2008,Fencing,1,0,1,2
"Valentina Vezzali",34,Italy,2008,Fencing,1,0,1,2
"Becca Ward",18,"United States",2008,Fencing,0,0,2,2
"Mariel Zagunis",23,"United States",2008,Fencing,1,0,1,2
"Tina Cook",37,"Great Britain",2008,Equestrian,0,0,2,2
"Heike Kemmer",46,Germany,2008,Equestrian,1,0,1,2
"Eric Lamaze",40,Canada,2008,Equestrian,1,1,0,2
"Beezie Madden",44,"United States",2008,Equestrian,1,0,1,2
"Hinrich Romeike",45,Germany,2008,Equestrian,2,0,0,2
"Anky van Grunsven",40,Netherlands,2008,Equestrian,1,1,0,2
"Isabell Werth",39,Germany,2008,Equestrian,1,1,0,2
"Chen Ruolin",15,China,2008,Diving,2,0,0,2
"Gleb Galperin",25,Russia,2008,Diving,0,0,2,2
"Guo Jingjing",26,China,2008,Diving,2,0,0,2
"Yuliya Pakhalina",30,Russia,2008,Diving,0,2,0,2
"Qin Kai",22,China,2008,Diving,1,0,1,2
"Wang Xin",16,China,2008,Diving,1,0,1,2
"Wu Minxia",22,China,2008,Diving,1,0,1,2
"Mickaël Bourgain",28,France,2008,Cycling,0,1,1,2
"Fabian Cancellara",27,Switzerland,2008,Cycling,1,1,0,2
"Jason Kenny",20,"Great Britain",2008,Cycling,1,1,0,2
"Joan Llaneras",39,Spain,2008,Cycling,1,1,0,2
"Hayden Roulston",27,"New Zealand",2008,Cycling,0,1,1,2
"Bradley Wiggins",28,"Great Britain",2008,Cycling,2,0,0,2
"Tim Brabants",31,"Great Britain",2008,Canoeing,1,0,1,2
"David Cal",25,Spain,2008,Canoeing,0,2,0,2
"Natasa Douchev-Janics",26,Hungary,2008,Canoeing,1,1,0,2
"Christian Gille",32,Germany,2008,Canoeing,0,1,1,2
"Katalin Kovács",32,Hungary,2008,Canoeing,1,1,0,2
"Vadim Makhnyov",28,Belarus,2008,Canoeing,1,0,1,2
"Roman Petrushenko",27,Belarus,2008,Canoeing,1,0,1,2
"Katrin Wagner-Augustin",30,Germany,2008,Canoeing,1,0,1,2
"Ken Wallace",25,Australia,2008,Canoeing,1,0,1,2
"Tomasz Wylenzek",25,Germany,2008,Canoeing,0,1,1,2
"Lee Hyo-Jeong",27,"South Korea",2008,Badminton,1,1,0,2
"Yu Yang",22,China,2008,Badminton,1,0,1,2
"Elvan Abeylegesse",25,Turkey,2008,Athletics,0,2,0,2
"Kenenisa Bekele",26,Ethiopia,2008,Athletics,2,0,0,2
"Kerron Clement",22,"United States",2008,Athletics,1,1,0,2
"Tirunesh Dibaba",23,Ethiopia,2008,Athletics,2,0,0,2
"Walter Dix",22,"United States",2008,Athletics,0,0,2,2
"Allyson Felix",22,"United States",2008,Athletics,1,1,0,2
"Yuliya Gushchina",25,Russia,2008,Athletics,1,1,0,2
"Tatyana Lebedeva",32,Russia,2008,Athletics,0,2,0,2
"LaShawn Merritt",22,"United States",2008,Athletics,2,0,0,2
"David Neville",24,"United States",2008,Athletics,1,0,1,2
"Sanya Richards-Ross",23,"United States",2008,Athletics,1,0,1,2
"Kerron Stewart",24,Jamaica,2008,Athletics,0,1,1,2
"Jared Tallent",23,Australia,2008,Athletics,0,1,1,2
"Angelo Taylor",29,"United States",2008,Athletics,2,0,0,2
"Richard Thompson",23,"Trinidad and Tobago",2008,Athletics,0,2,0,2
"Jeremy Wariner",24,"United States",2008,Athletics,1,1,0,2
"Shericka Williams",22,Jamaica,2008,Athletics,0,1,1,2
"Park Gyeong-Mo",32,"South Korea",2008,Archery,1,1,0,2
"Park Seong-Hyeon",25,"South Korea",2008,Archery,1,1,0,2
"Yun Ok-Hui",23,"South Korea",2008,Archery,1,0,1,2
"Zhang Juanjuan",27,China,2008,Archery,1,1,0,2
"Yusuf Abdusalomov",30,Tajikistan,2008,Wrestling,0,1,0,1
"Bakhtiyar Akhmedov",21,Russia,2008,Wrestling,0,1,0,1
"Islam-Beka Albiyev",19,Russia,2008,Wrestling,1,0,0,1
"Roman Amoyan",24,Armenia,2008,Wrestling,0,0,1,1
"Nazmi Avluca",31,Turkey,2008,Wrestling,0,0,1,1
"Khasan Baroyev",25,Russia,2008,Wrestling,0,1,0,1
"Mavlet Batyrov",24,Russia,2008,Wrestling,1,0,0,1
"Rövs?n Bayramov",21,Azerbaijan,2008,Wrestling,0,1,0,1
"Kanat Begaliyev",24,Kyrgyzstan,2008,Wrestling,0,1,0,1
"Henry Cejudo",21,"United States",2008,Wrestling,1,0,0,1
"Chang Yongxiang",24,China,2008,Wrestling,0,1,0,1
"Taras Danko",28,Ukraine,2008,Wrestling,0,0,1,1
"Mirko Englich",29,Germany,2008,Wrestling,0,1,0,1
"Vasyl Fedoryshyn",27,Ukraine,2008,Wrestling,0,1,0,1
"Zoltán Fodor",23,Hungary,2008,Wrestling,0,1,0,1
"Murad Gaydarov",28,Belarus,2008,Wrestling,0,0,1,1
"Giorgi Gogshelidze",28,Georgia,2008,Wrestling,0,0,1,1
"Christophe Guénot",29,France,2008,Wrestling,0,0,1,1
"Steeve Guénot",22,France,2008,Wrestling,1,0,0,1
"Kyoko Hamaguchi",30,Japan,2008,Wrestling,0,0,1,1
"Carol Huynh",27,Canada,2008,Wrestling,1,0,0,1
"Chiharu Icho",26,Japan,2008,Wrestling,0,1,0,1
"Kaori Icho",24,Japan,2008,Wrestling,1,0,0,1
"Manuchar K'virk'elia",29,Georgia,2008,Wrestling,1,0,0,1
"Alyona Kartashova",26,Russia,2008,Wrestling,0,1,0,1
"Georgy Ketoyev",22,Russia,2008,Wrestling,0,0,1,1
"Aslanbek Khushtov",28,Russia,2008,Wrestling,1,0,0,1
"Besik Kudukhov",22,Russia,2008,Wrestling,0,0,1,1
"Sushil Kumar",25,India,2008,Wrestling,0,0,1,1
"Mijaín López",25,Cuba,2008,Wrestling,1,0,0,1
"Aset Mambetov",26,Kazakhstan,2008,Wrestling,0,0,1,1
"Nazyr Mankiyev",23,Russia,2008,Wrestling,1,0,0,1
"Tomohiro Matsunaga",28,Japan,2008,Wrestling,0,1,0,1
"Iryna Merleni-Mykulchyn",26,Ukraine,2008,Wrestling,0,0,1,1
"Randi Miller",24,"United States",2008,Wrestling,0,0,1,1
"Revaz Mindorashvili",32,Georgia,2008,Wrestling,1,0,0,1
"Andrea Minguzzi",26,Italy,2008,Wrestling,1,0,0,1
"Mindaugas Mizgaitis",28,Lithuania,2008,Wrestling,0,0,1,1
"Seyed Mohammadi",28,Iran,2008,Wrestling,0,0,1,1
"Sharvani Muradov",23,Russia,2008,Wrestling,1,0,0,1
"David Musulbes",36,Slovakia,2008,Wrestling,0,0,1,1
"Marid Mutalimov",28,Kazakhstan,2008,Wrestling,0,0,1,1
"Park Eun-Chul",27,"South Korea",2008,Wrestling,0,0,1,1
"Yury Patrikeyev",28,Armenia,2008,Wrestling,0,0,1,1
"Xetaq Qazyumov",25,Azerbaijan,2008,Wrestling,0,0,1,1
"Jackeline Rentería",22,Colombia,2008,Wrestling,0,0,1,1
"Vitaliy R?himov",23,Azerbaijan,2008,Wrestling,0,1,0,1
"Ramazan Sahin",25,Turkey,2008,Wrestling,1,0,0,1
"Buvaisa Saytiyev",33,Russia,2008,Wrestling,1,0,0,1
"Mikhail Semyonov",24,Belarus,2008,Wrestling,0,0,1,1
"Yelena Shalygina",21,Kazakhstan,2008,Wrestling,0,0,1,1
"Andriy Stadnik",26,Ukraine,2008,Wrestling,0,1,0,1
"Mariya Stadnik",20,Azerbaijan,2008,Wrestling,0,0,1,1
"Artur Taymazov",29,Uzbekistan,2008,Wrestling,1,0,0,1
"Nurbakyt Tengizbayev",25,Kazakhstan,2008,Wrestling,0,0,1,1
"Kiril Terziev",24,Bulgaria,2008,Wrestling,0,0,1,1
"Soslan Tigiyev",24,Uzbekistan,2008,Wrestling,0,1,0,1
"Taymuraz Tigiyev",26,Kazakhstan,2008,Wrestling,0,1,0,1
"Otar Tushishvili",30,Georgia,2008,Wrestling,0,0,1,1
"Ruslan Tyumenbayev",22,Kyrgyzstan,2008,Wrestling,0,0,1,1
"Armen Vardanian",25,Ukraine,2008,Wrestling,0,0,1,1
"Radoslav Velikov",24,Bulgaria,2008,Wrestling,0,0,1,1
"Tonya Verbeek",31,Canada,2008,Wrestling,0,0,1,1
"Wang Jiao",20,China,2008,Wrestling,1,0,0,1
"Adam Wheeler",27,"United States",2008,Wrestling,0,0,1,1
"Agnieszka Wieszczek",25,Poland,2008,Wrestling,0,0,1,1
"Xu Li",18,China,2008,Wrestling,0,1,0,1
"Yavor Yanakiev",23,Bulgaria,2008,Wrestling,0,0,1,1
"Saori Yoshida",25,Japan,2008,Wrestling,1,0,0,1
"Kenichi Yumoto",23,Japan,2008,Wrestling,0,0,1,1
"Stanka Zlateva",25,Bulgaria,2008,Wrestling,0,1,0,1
"Khadzhimurat Akkayev",23,Russia,2008,Weightlifting,0,0,1,1
"Andrey Aryamnov",20,Belarus,2008,Weightlifting,1,0,0,1
"Cao Lei",24,China,2008,Weightlifting,1,0,0,1
"Chen Wei-Ling",26,"Chinese Taipei",2008,Weightlifting,0,0,1,1
"Chen Xiexia",25,China,2008,Weightlifting,1,0,0,1
"Chen Yanqing",29,China,2008,Weightlifting,1,0,0,1
"Yevgeny Chigishev",29,Russia,2008,Weightlifting,0,1,0,1
"Vencelas Dabaya",27,France,2008,Weightlifting,0,1,0,1
"Gevorg Davtyan",25,Armenia,2008,Weightlifting,0,0,1,1
"Nataliya Davydova",23,Ukraine,2008,Weightlifting,0,0,1,1
"Mariya Grabovetskaya",21,Kazakhstan,2008,Weightlifting,0,0,1,1
"Hoàng Anh Tu?n",23,Vietnam,2008,Weightlifting,0,1,0,1
"Ilya Ilyin",20,Kazakhstan,2008,Weightlifting,1,0,0,1
"Eko Irawan",19,Indonesia,2008,Weightlifting,0,0,1,1
"Jang Mi-Ran",24,"South Korea",2008,Weightlifting,1,0,0,1
"Prapawadee Jaroenrattanatarakoon",24,Thailand,2008,Weightlifting,1,0,0,1
"Dmitry Klokov",25,Russia,2008,Weightlifting,0,1,0,1
"Olha Korobka",22,Ukraine,2008,Weightlifting,0,1,0,1
"Szymon Kolecki",26,Poland,2008,Weightlifting,0,1,0,1
"Dmitry Lapikov",26,Russia,2008,Weightlifting,0,0,1,1
"Li Hongli",27,China,2008,Weightlifting,0,1,0,1
"Liao Hui",20,China,2008,Weightlifting,1,0,0,1
"Liu Chunhong",25,China,2008,Weightlifting,1,0,0,1
"Long Qingquan",17,China,2008,Weightlifting,1,0,0,1
"Lu Ying-Chi",23,"Chinese Taipei",2008,Weightlifting,0,0,1,1
"Lu Yong",22,China,2008,Weightlifting,1,0,0,1
"Tigran G. Martirosyan",20,Armenia,2008,Weightlifting,0,0,1,1
"Tigran V. Martirosyan",25,Armenia,2008,Weightlifting,0,0,1,1
"Irina Nekrasova",20,Kazakhstan,2008,Weightlifting,0,1,0,1
"Anastasiya Novikova",26,Belarus,2008,Weightlifting,0,0,1,1
"O Jong-Ae",24,"North Korea",2008,Weightlifting,0,0,1,1
"Sibel Özkan",20,Turkey,2008,Weightlifting,0,1,0,1
"Pak Hyon-Suk",23,"North Korea",2008,Weightlifting,1,0,0,1
"Andrey Rybakov",26,Belarus,2008,Weightlifting,0,1,0,1
"Sa Jae-Hyeok",23,"South Korea",2008,Weightlifting,1,0,0,1
"Diego Fernando Salazar",27,Colombia,2008,Weightlifting,0,1,0,1
"Viktors Šcerbatihs",33,Latvia,2008,Weightlifting,0,0,1,1
"Marina Shainova",22,Russia,2008,Weightlifting,0,1,0,1
"Oksana Slivenko",21,Russia,2008,Weightlifting,0,1,0,1
"Matthias Steiner",25,Germany,2008,Weightlifting,1,0,0,1
Triyatno,20,Indonesia,2008,Weightlifting,0,0,1,1
"Alla Vazhenina",25,Kazakhstan,2008,Weightlifting,0,1,0,1
"Nadezhda Yevstyukhina",20,Russia,2008,Weightlifting,0,0,1,1
"Yoon Jin-Hee",22,"South Korea",2008,Weightlifting,0,1,0,1
"Zhang Xiangxiang",25,China,2008,Weightlifting,1,0,0,1
"Betsey Armstrong",25,"United States",2008,Waterpolo,0,1,0,1
"Tony Azevedo",26,"United States",2008,Waterpolo,0,1,0,1
"Ryan Bailey",32,"United States",2008,Waterpolo,0,1,0,1
"Gemma Beadsworth",21,Australia,2008,Waterpolo,0,0,1,1
"Layne Beaubien",32,"United States",2008,Waterpolo,0,1,0,1
"Tibor Benedek",36,Hungary,2008,Waterpolo,1,0,0,1
"Péter Biros",32,Hungary,2008,Waterpolo,1,0,0,1
"Brandon Brooks",27,"United States",2008,Waterpolo,0,1,0,1
"Mieke Cabout",22,Netherlands,2008,Waterpolo,1,0,0,1
"Patty Cardenas",23,"United States",2008,Waterpolo,0,1,0,1
"Aleksandar Ciric",30,Serbia,2008,Waterpolo,0,0,1,1
"Kami Craig",21,"United States",2008,Waterpolo,0,1,0,1
"Nikita Cuffe",28,Australia,2008,Waterpolo,0,0,1,1
"Daniëlle de Bruijn",30,Netherlands,2008,Waterpolo,1,0,0,1
"Filip Filipovic",21,Serbia,2008,Waterpolo,0,0,1,1
"Suzie Fraser",19,Australia,2008,Waterpolo,0,0,1,1
"István Gergely",31,Hungary,2008,Waterpolo,1,0,0,1
"Živko Gocic",25,Serbia,2008,Waterpolo,0,0,1,1
"Taniele Gofers",23,Australia,2008,Waterpolo,0,0,1,1
"Natalie Golda",26,"United States",2008,Waterpolo,0,1,0,1
"Alison Gregorka",23,"United States",2008,Waterpolo,0,1,0,1
"Rianne Guichelaar",24,Netherlands,2008,Waterpolo,1,0,0,1
"Kate Gynther",26,Australia,2008,Waterpolo,0,0,1,1
"Biurakn Hakhverdian",22,Netherlands,2008,Waterpolo,1,0,0,1
"Brittany Hayes",23,"United States",2008,Waterpolo,0,1,0,1
"Amy Hetzel",25,Australia,2008,Waterpolo,0,0,1,1
"Jaime Hipp",26,"United States",2008,Waterpolo,0,1,0,1
"Norbert Hosnyánszky",24,Hungary,2008,Waterpolo,1,0,0,1
"Peter Hudnut",28,"United States",2008,Waterpolo,0,1,0,1
"Tim Hutten",23,"United States",2008,Waterpolo,0,1,0,1
"Tamás Kásás",32,Hungary,2008,Waterpolo,1,0,0,1
"Gábor Kis",25,Hungary,2008,Waterpolo,1,0,0,1
"Gergo Kiss",30,Hungary,2008,Waterpolo,1,0,0,1
"Noeki Klein",25,Netherlands,2008,Waterpolo,1,0,0,1
"Bronwen Knox",22,Australia,2008,Waterpolo,0,0,1,1
"Emma Knox",30,Australia,2008,Waterpolo,0,0,1,1
"Simone Koot",27,Netherlands,2008,Waterpolo,1,0,0,1
"J. W. Krumpholz",20,"United States",2008,Waterpolo,0,1,0,1
"Norbert Madaras",28,Hungary,2008,Waterpolo,1,0,0,1
"Alicia McCormack",25,Australia,2008,Waterpolo,0,0,1,1
"Rick Merlo",26,"United States",2008,Waterpolo,0,1,0,1
"Tamás Molnár",33,Hungary,2008,Waterpolo,1,0,0,1
"Merrill Moses",30,"United States",2008,Waterpolo,0,1,0,1
"Branko Pekovic",29,Serbia,2008,Waterpolo,0,0,1,1
"Heather Petri",30,"United States",2008,Waterpolo,0,1,0,1
"Duško Pijetlovic",23,Serbia,2008,Waterpolo,0,0,1,1
"Jeff Powers",28,"United States",2008,Waterpolo,0,1,0,1
"Andrija Prlainovic",21,Serbia,2008,Waterpolo,0,0,1,1
"Nikola Raden",23,Serbia,2008,Waterpolo,0,0,1,1
"Bec Rippon",29,Australia,2008,Waterpolo,0,0,1,1
"Mel Rippon",27,Australia,2008,Waterpolo,0,0,1,1
"Jenna Santoromito",21,Australia,2008,Waterpolo,0,0,1,1
"Mia Santoromito",23,Australia,2008,Waterpolo,0,0,1,1
"Aleksandar Šapic",30,Serbia,2008,Waterpolo,0,0,1,1
"Dejan Savic",33,Serbia,2008,Waterpolo,0,0,1,1
"Denis Šefik",31,Serbia,2008,Waterpolo,0,0,1,1
"Alette Sijbring",26,Netherlands,2008,Waterpolo,1,0,0,1
"Yasemin Smit",23,Netherlands,2008,Waterpolo,1,0,0,1
"Jesse Smith",25,"United States",2008,Waterpolo,0,1,0,1
"Slobodan Soro",29,Serbia,2008,Waterpolo,0,0,1,1
"Jessica Steffens",21,"United States",2008,Waterpolo,0,1,0,1
"Zoltán Szécsi",30,Hungary,2008,Waterpolo,1,0,0,1
"Vanja Udovicic",25,Serbia,2008,Waterpolo,0,0,1,1
"Iefke van Belkum",22,Netherlands,2008,Waterpolo,1,0,0,1
"Gillian van den Berg",36,Netherlands,2008,Waterpolo,1,0,0,1
"Marieke van den Ham",25,Netherlands,2008,Waterpolo,1,0,0,1
"Ilse van der Meijden",19,Netherlands,2008,Waterpolo,1,0,0,1
"Moriah Van Norman",24,"United States",2008,Waterpolo,0,1,0,1
"Peter Varellas",23,"United States",2008,Waterpolo,0,1,0,1
"Dániel Varga",24,Hungary,2008,Waterpolo,1,0,0,1
"Dénes Varga",21,Hungary,2008,Waterpolo,1,0,0,1
"Tamás Varga",33,Hungary,2008,Waterpolo,1,0,0,1
"Brenda Villa",28,"United States",2008,Waterpolo,0,1,0,1
"Vlada Vujasinovic",34,Serbia,2008,Waterpolo,0,0,1,1
"Lauren Wenger",24,"United States",2008,Waterpolo,0,1,0,1
"Elsie Windes",23,"United States",2008,Waterpolo,0,1,0,1
"Adam Wright",31,"United States",2008,Waterpolo,0,1,0,1
"Robyn Ah Mow-Santos",32,"United States",2008,Volleyball,0,1,0,1
Anderson,34,Brazil,2008,Volleyball,0,1,0,1
"Lloy Ball",36,"United States",2008,Volleyball,1,0,0,1
"Yury Berezhko",24,Russia,2008,Volleyball,0,0,1,1
"Lindsey Berg",28,"United States",2008,Volleyball,0,1,0,1
"Heather Bown",29,"United States",2008,Volleyball,0,1,0,1
Bruninho,22,Brazil,2008,Volleyball,0,1,0,1
Carol,31,Brazil,2008,Volleyball,1,0,0,1
Dante,27,Brazil,2008,Volleyball,0,1,0,1
"Nicole Davis",26,"United States",2008,Volleyball,0,1,0,1
Escadinha,32,Brazil,2008,Volleyball,0,1,0,1
Fabi,28,Brazil,2008,Volleyball,1,0,0,1
Fabiana,23,Brazil,2008,Volleyball,1,0,0,1
"Feng Kun",29,China,2008,Volleyball,0,0,1,1
Fofão,38,Brazil,2008,Volleyball,1,0,0,1
"Gabe Gardner",32,"United States",2008,Volleyball,1,0,0,1
Giba,31,Brazil,2008,Volleyball,0,1,0,1
"Kim Glass",23,"United States",2008,Volleyball,0,1,0,1
"Sergey Grankin",23,Russia,2008,Volleyball,0,0,1,1
Gustavo,32,Brazil,2008,Volleyball,0,1,0,1
"Tayyiba Haneef-Park",29,"United States",2008,Volleyball,0,1,0,1
"Kevin Hansen",26,"United States",2008,Volleyball,1,0,0,1
"André Heller",32,Brazil,2008,Volleyball,0,1,0,1
"Tom Hoff",35,"United States",2008,Volleyball,1,0,0,1
"Pereira de Carvalho Endres Jaque",24,Brazil,2008,Volleyball,1,0,0,1
"Jennifer Joines",25,"United States",2008,Volleyball,0,1,0,1
"Vadim Khamuttskikh",38,Russia,2008,Volleyball,0,0,1,1
"Aleksandr Korneyev",27,Russia,2008,Volleyball,0,0,1,1
"Aleksandr Kosaryev",30,Russia,2008,Volleyball,0,0,1,1
"Aleksey Kuleshov",29,Russia,2008,Volleyball,0,0,1,1
"Rich Lambourne",33,"United States",2008,Volleyball,1,0,0,1
"David Lee",26,"United States",2008,Volleyball,1,0,0,1
"Li Juan",27,China,2008,Volleyball,0,0,1,1
"Liu Yanan",27,China,2008,Volleyball,0,0,1,1
"Ma Yunwen",21,China,2008,Volleyball,0,0,1,1
Marcelinho,33,Brazil,2008,Volleyball,0,1,0,1
Mari,24,Brazil,2008,Volleyball,1,0,0,1
"Maksim Mikhaylov",20,Russia,2008,Volleyball,0,0,1,1
"Ryan Millar",30,"United States",2008,Volleyball,1,0,0,1
Murilo,27,Brazil,2008,Volleyball,0,1,0,1
"André Nascimento",29,Brazil,2008,Volleyball,0,1,0,1
"Ogonna Nnamani",25,"United States",2008,Volleyball,0,1,0,1
"Aleksey Ostapenko",22,Russia,2008,Volleyball,0,0,1,1
Paula,26,Brazil,2008,Volleyball,1,0,0,1
"Semyon Poltavsky",27,Russia,2008,Volleyball,0,0,1,1
"Reid Priddy",30,"United States",2008,Volleyball,1,0,0,1
Rodrigão,29,Brazil,2008,Volleyball,0,1,0,1
"Sean Rooney",25,"United States",2008,Volleyball,1,0,0,1
"Riley Salmon",32,"United States",2008,Volleyball,1,0,0,1
Samuel,24,Brazil,2008,Volleyball,0,1,0,1
Sassá,25,Brazil,2008,Volleyball,1,0,0,1
"Danielle Scott-Arruda",35,"United States",2008,Volleyball,0,1,0,1
Sheilla,25,Brazil,2008,Volleyball,1,0,0,1
"Clay Stanley",30,"United States",2008,Volleyball,1,0,0,1
"Stacy Sykora",31,"United States",2008,Volleyball,0,1,0,1
"Sergey Tetyukhin",32,Russia,2008,Volleyball,0,0,1,1
Thaísa,21,Brazil,2008,Volleyball,1,0,0,1
"Logan Tom",27,"United States",2008,Volleyball,0,1,0,1
"Scott Touzinsky",26,"United States",2008,Volleyball,1,0,0,1
Valeskinha,32,Brazil,2008,Volleyball,1,0,0,1
"Aleksey Verbov",26,Russia,2008,Volleyball,0,0,1,1
"Aleksandr Volkov",23,Russia,2008,Volleyball,0,0,1,1
Walewska,29,Brazil,2008,Volleyball,1,0,0,1
"Wang Yimei",20,China,2008,Volleyball,0,0,1,1
"Wei Qiuyue",19,China,2008,Volleyball,0,0,1,1
"Kim Willoughby",27,"United States",2008,Volleyball,0,1,0,1
"Xu Yunli",21,China,2008,Volleyball,0,0,1,1
"Xue Ming",21,China,2008,Volleyball,0,0,1,1
"Yang Hao",28,China,2008,Volleyball,0,0,1,1
"Zhang Na",28,China,2008,Volleyball,0,0,1,1
"Zhao Ruirui",26,China,2008,Volleyball,0,0,1,1
"Zhou Suhong",29,China,2008,Volleyball,0,0,1,1
"Timo Boll",27,Germany,2008,"Table Tennis",0,1,0,1
"Dang Ye-Seo",27,"South Korea",2008,"Table Tennis",0,0,1,1
"Feng Tian Wei",21,Singapore,2008,"Table Tennis",0,1,0,1
"Kim Gyeong-A",31,"South Korea",2008,"Table Tennis",0,0,1,1
"Li Jia Wei",27,Singapore,2008,"Table Tennis",0,1,0,1
"O Sang-Eun",31,"South Korea",2008,"Table Tennis",0,0,1,1
"Dmitrij Ovtcharov",19,Germany,2008,"Table Tennis",0,1,0,1
"Park Mi-Yeong",26,"South Korea",2008,"Table Tennis",0,0,1,1
"Christian Süß",23,Germany,2008,"Table Tennis",0,1,0,1
"Wang Jue Gu",28,Singapore,2008,"Table Tennis",0,1,0,1
"Yoon Jae-Young",25,"South Korea",2008,"Table Tennis",0,0,1,1
"Yu Seung-Min",26,"South Korea",2008,"Table Tennis",0,0,1,1
"Bevan Docherty",31,"New Zealand",2008,Triathlon,0,0,1,1
"Vanessa Fernandes",22,Portugal,2008,Triathlon,0,1,0,1
"Jan Frodeno",27,Germany,2008,Triathlon,1,0,0,1
"Emma Moffatt",23,Australia,2008,Triathlon,0,0,1,1
"Emma Snowsill",27,Australia,2008,Triathlon,1,0,0,1
"Simon Whitfield",33,Canada,2008,Triathlon,0,1,0,1
"Jason Burnett",21,Canada,2008,Trampoline,0,1,0,1
"Karen Cockburn",28,Canada,2008,Trampoline,0,1,0,1
"Dong Dong",19,China,2008,Trampoline,0,0,1,1
"He Wenna",19,China,2008,Trampoline,1,0,0,1
"Yekaterina Khilko",26,Uzbekistan,2008,Trampoline,0,0,1,1
"Lu Chunlong",19,China,2008,Trampoline,1,0,0,1
"Arman Chilmanov",24,Kazakhstan,2008,Taekwondo,0,0,1,1
"Chu Mu-Yen",26,"Chinese Taipei",2008,Taekwondo,0,0,1,1
"Chika Chukwumerije",24,Nigeria,2008,Taekwondo,0,0,1,1
"Dalia Contreras",24,Venezuela,2008,Taekwondo,0,0,1,1
"Gwladys Epangue",25,France,2008,Taekwondo,0,0,1,1
"María Espinoza",20,Mexico,2008,Taekwondo,1,0,0,1
"Natália Falavigna",24,Brazil,2008,Taekwondo,0,0,1,1
"Hwang Gyeong-Seon",22,"South Korea",2008,Taekwondo,1,0,0,1
"Im Su-Jeong",22,"South Korea",2008,Taekwondo,1,0,0,1
"Ja Dong-Min",21,"South Korea",2008,Taekwondo,1,0,0,1
"Diana Lopez",24,"United States",2008,Taekwondo,0,0,1,1
"Mark Lopez",26,"United States",2008,Taekwondo,0,1,0,1
"Steven Lopez",29,"United States",2008,Taekwondo,0,0,1,1
"Yulis Mercedes",28,"Dominican Republic",2008,Taekwondo,0,1,0,1
"Daynellis Montejo",23,Cuba,2008,Taekwondo,0,0,1,1
"Alexandros Nikolaidis",28,Greece,2008,Taekwondo,0,1,0,1
"Rohullah Nikpai",21,Afghanistan,2008,Taekwondo,0,0,1,1
"Guillermo Pérez",28,Mexico,2008,Taekwondo,1,0,0,1
"Buttree Puedpong",17,Thailand,2008,Taekwondo,0,1,0,1
"Hadi Saei",32,Iran,2008,Taekwondo,1,0,0,1
"Sandra Šaric",24,Croatia,2008,Taekwondo,0,0,1,1
"Mauro Sarmiento",25,Italy,2008,Taekwondo,0,1,0,1
"Karine Sergerie",23,Canada,2008,Taekwondo,0,1,0,1
"Nina Solheim",29,Norway,2008,Taekwondo,0,1,0,1
"Son Tae-Jin",20,"South Korea",2008,Taekwondo,1,0,0,1
"Sarah Stevenson",25,"Great Britain",2008,Taekwondo,0,0,1,1
"Sung Yu-Chi",26,"Chinese Taipei",2008,Taekwondo,0,0,1,1
"Azize Tanrikulu",22,Turkey,2008,Taekwondo,0,1,0,1
"Servet Tazegül",19,Turkey,2008,Taekwondo,0,0,1,1
"Wu Jingyu",21,China,2008,Taekwondo,1,0,0,1
"Zhu Guo",23,China,2008,Taekwondo,0,0,1,1
"Martina Zubcic",19,Croatia,2008,Taekwondo,0,0,1,1
"Simon Aspelin",34,Sweden,2008,Tennis,0,1,0,1
"Bob Bryan",30,"United States",2008,Tennis,0,0,1,1
"Mike Bryan",30,"United States",2008,Tennis,0,0,1,1
"Yelena Dementyeva",26,Russia,2008,Tennis,1,0,0,1
"Roger Federer",27,Switzerland,2008,Tennis,1,0,0,1
"Fernando González",28,Chile,2008,Tennis,0,1,0,1
"Thomas Johansson",33,Sweden,2008,Tennis,0,1,0,1
"Anabel Medina",26,Spain,2008,Tennis,0,1,0,1
"Rafael Nadal",22,Spain,2008,Tennis,1,0,0,1
"Vivi Ruano",34,Spain,2008,Tennis,0,1,0,1
"Dinara Safina",22,Russia,2008,Tennis,0,1,0,1
"Stanislas Wawrinka",23,Switzerland,2008,Tennis,1,0,0,1
"Serena Williams",26,"United States",2008,Tennis,1,0,0,1
"Venus Williams",28,"United States",2008,Tennis,1,0,0,1
"Yan Zi",23,China,2008,Tennis,0,0,1,1
"Zheng Jie",25,China,2008,Tennis,0,0,1,1
"Vera Zvonaryova",23,Russia,2008,Tennis,0,0,1,1
"Novak Ðokovic",21,Serbia,2008,Tennis,0,0,1,1
"Alba Cabello",22,Spain,2008,"Synchronized Swimming",0,1,0,1
"Raquel Corral",27,Spain,2008,"Synchronized Swimming",0,1,0,1
"Mariya Gromova",24,Russia,2008,"Synchronized Swimming",1,0,0,1
"Gu Beibei",27,China,2008,"Synchronized Swimming",0,0,1,1
"Saho Harada",25,Japan,2008,"Synchronized Swimming",0,0,1,1
"Thais Henríquez",25,Spain,2008,"Synchronized Swimming",0,1,0,1
"Huang Xuechen",18,China,2008,"Synchronized Swimming",0,0,1,1
"Nataliya Ishchenko",22,Russia,2008,"Synchronized Swimming",1,0,0,1
"Jiang Tingting",21,China,2008,"Synchronized Swimming",0,0,1,1
"Jiang Wenwen",21,China,2008,"Synchronized Swimming",0,0,1,1
"Elvira Khasyanova",27,Russia,2008,"Synchronized Swimming",1,0,0,1
"Olga Kuzhela",22,Russia,2008,"Synchronized Swimming",1,0,0,1
"Liu Ou",21,China,2008,"Synchronized Swimming",0,0,1,1
"Laura López",20,Spain,2008,"Synchronized Swimming",0,1,0,1
"Luo Xi",20,China,2008,"Synchronized Swimming",0,0,1,1
"Yelena Ovchinnikova",26,Russia,2008,"Synchronized Swimming",1,0,0,1
"Irina Rodríguez",30,Spain,2008,"Synchronized Swimming",0,1,0,1
"Svetlana Romashina",18,Russia,2008,"Synchronized Swimming",1,0,0,1
"Anna Shorina",25,Russia,2008,"Synchronized Swimming",1,0,0,1
"Sun Qiuting",22,China,2008,"Synchronized Swimming",0,0,1,1
"Emiko Suzuki",26,Japan,2008,"Synchronized Swimming",0,0,1,1
"Paola Tirados",28,Spain,2008,"Synchronized Swimming",0,1,0,1
"Wang Na",24,China,2008,"Synchronized Swimming",0,0,1,1
"Zhang Xiaohuan",28,China,2008,"Synchronized Swimming",0,0,1,1
"Nathan Adrian",19,"United States",2008,Swimming,1,0,0,1
"Angie Bainbridge",18,Australia,2008,Swimming,1,0,0,1
"Bronte Barratt",19,Australia,2008,Swimming,1,0,0,1
"Ricky Berens",20,"United States",2008,Swimming,1,0,0,1
"Fréd Bousquet",27,France,2008,Swimming,0,1,0,1
"Elaine Breeden",19,"United States",2008,Swimming,0,1,0,1
"Grant Brits",21,Australia,2008,Swimming,0,0,1,1
"Caroline Burckle",22,"United States",2008,Swimming,0,0,1,1
"Ashley Callus",29,Australia,2008,Swimming,0,0,1,1
"Milorad Cavic",24,Serbia,2008,Swimming,0,1,0,1
"Ryan Cochrane",19,Canada,2008,Swimming,0,0,1,1
"Ian Crocker",25,"United States",2008,Swimming,1,0,0,1
"Lara Davenport",24,Australia,2008,Swimming,1,0,0,1
"Dave Davies",23,"Great Britain",2008,Swimming,0,1,0,1
"Inge Dekker",22,Netherlands,2008,Swimming,1,0,0,1
"Ash Delaney",22,Australia,2008,Swimming,0,1,0,1
"Nick Ffrost",21,Australia,2008,Swimming,0,0,1,1
"Alessia Filippi",21,Italy,2008,Swimming,0,1,0,1
"Lotte Friis",20,Denmark,2008,Swimming,0,0,1,1
"Takuro Fujii",23,Japan,2008,Swimming,0,0,1,1
"Mark Gangloff",26,"United States",2008,Swimming,1,0,0,1
"Fabien Gilot",24,France,2008,Swimming,0,1,0,1
"Brendan Hansen",27,"United States",2008,Swimming,1,0,0,1
"Femke Heemskerk",20,Netherlands,2008,Swimming,1,0,0,1
"Lara Ilchenko",19,Russia,2008,Swimming,1,0,0,1
"Sara Isakovic",20,Slovenia,2008,Swimming,0,1,0,1
"Dan Izotov",16,Russia,2008,Swimming,0,1,0,1
"Jo Jackson",21,"Great Britain",2008,Swimming,0,0,1,1
"Larsen Jensen",22,"United States",2008,Swimming,0,0,1,1
"Jiao Liuyang",18,China,2008,Swimming,0,1,0,1
"Cullen Jones",24,"United States",2008,Swimming,1,0,0,1
"Mirna Jukic",22,Austria,2008,Swimming,0,0,1,1
"Klete Keller",26,"United States",2008,Swimming,1,0,0,1
"Ranomi Kromowidjojo",17,Netherlands,2008,Swimming,1,0,0,1
"Yevgeny Lagunov",22,Russia,2008,Swimming,0,1,0,1
"Liu Zige",19,China,2008,Swimming,1,0,0,1
"Nikita Lobintsev",19,Russia,2008,Swimming,0,1,0,1
"Thomas Lurz",28,Germany,2008,Swimming,0,0,1,1
"Linda MacKenzie",24,Australia,2008,Swimming,1,0,0,1
"Grégory Mallet",24,France,2008,Swimming,0,1,0,1
"Christine Marshall",22,"United States",2008,Swimming,0,0,1,1
"Takeshi Matsuda",24,Japan,2008,Swimming,0,0,1,1
"Oussama Mellouli",24,Tunisia,2008,Swimming,1,0,0,1
"Alice Mills",22,Australia,2008,Swimming,0,0,1,1
"Junichi Miyashita",24,Japan,2008,Swimming,0,0,1,1
"Reiko Nakamura",26,Japan,2008,Swimming,0,0,1,1
"Sara Nordenstam",25,Norway,2008,Swimming,0,0,1,1
"Lacey Nymeyer",22,"United States",2008,Swimming,0,1,0,1
"Alexander Dale Oen",23,Norway,2008,Swimming,0,1,0,1
"Kirk Palmer",21,Australia,2008,Swimming,0,0,1,1
"Kylie Palmer",18,Australia,2008,Swimming,1,0,0,1
"Cassie Patten",21,"Great Britain",2008,Swimming,0,0,1,1
"Keri-Anne Payne",20,"Great Britain",2008,Swimming,0,1,0,1
"Federica Pellegrini",20,Italy,2008,Swimming,1,0,0,1
"Adam Pine",32,Australia,2008,Swimming,0,1,0,1
"Mikhail Polishchuk",19,Russia,2008,Swimming,0,1,0,1
"Megan Quann-Jendrick",24,"United States",2008,Swimming,0,1,0,1
"Hisayoshi Sato",21,Japan,2008,Swimming,0,0,1,1
"Allison Schmitt",18,"United States",2008,Swimming,0,0,1,1
"Hinkelien Schreuder",24,Netherlands,2008,Swimming,1,0,0,1
"Emily Seebohm",16,Australia,2008,Swimming,1,0,0,1
"Emily Silver",22,"United States",2008,Swimming,0,1,0,1
"Christian Sprenger",22,Australia,2008,Swimming,0,1,0,1
"Boris Steimetz",21,France,2008,Swimming,0,1,0,1
"Aleksandr Sukhorukov",20,Russia,2008,Swimming,0,1,0,1
"Sun Ye",19,China,2008,Swimming,0,0,1,1
"Tan Miao",21,China,2008,Swimming,0,1,0,1
"Tang Jingzhi",21,China,2008,Swimming,0,1,0,1
"Maarten van der Weijden",27,Netherlands,2008,Swimming,1,0,0,1
"Manon van Rooijen",26,Netherlands,2008,Swimming,1,0,0,1
"Kim Vandenberg",24,"United States",2008,Swimming,0,0,1,1
"Marleen Veldhuis",29,Netherlands,2008,Swimming,1,0,0,1
"Erik Vendt",27,"United States",2008,Swimming,1,0,0,1
"Dave Walters",20,"United States",2008,Swimming,1,0,0,1
"Tarnee White",27,Australia,2008,Swimming,1,0,0,1
"Ben Wildman-Tobriner",23,"United States",2008,Swimming,1,0,0,1
"Xu Tianlongzi",17,China,2008,Swimming,0,0,1,1
"Yang Yu",23,China,2008,Swimming,0,1,0,1
"Zhang Lin",21,China,2008,Swimming,0,1,0,1
"Zhao Jing",17,China,2008,Swimming,0,0,1,1
"Zhou Yafei",24,China,2008,Swimming,0,0,1,1
"Zhu Qianwei",17,China,2008,Swimming,0,1,0,1
"Monica Abbott",23,"United States",2008,Softball,0,1,0,1
"Sandy Allen-Lewis",29,Australia,2008,Softball,0,0,1,1
"Laura Berg",33,"United States",2008,Softball,0,1,0,1
"Jodie Bowering",26,Australia,2008,Softball,0,0,1,1
"Crystl Bustos",30,"United States",2008,Softball,0,1,0,1
"Kylie Cronk",24,Australia,2008,Softball,0,0,1,1
"Andrea Duran",24,"United States",2008,Softball,0,1,0,1
"Naho Emoto",22,Japan,2008,Softball,1,0,0,1
"Jennie Finch",27,"United States",2008,Softball,0,1,0,1
"Tairia Flowers",27,"United States",2008,Softball,0,1,0,1
"Motoko Fujimoto",27,Japan,2008,Softball,1,0,0,1
"Vicky Galindo",24,"United States",2008,Softball,0,1,0,1
"Kelly Hardie",38,Australia,2008,Softball,0,0,1,1
"Tanya Harding",36,Australia,2008,Softball,0,0,1,1
"Megu Hirose",27,Japan,2008,Softball,1,0,0,1
"Emi Inui",24,Japan,2008,Softball,1,0,0,1
"Sachiko Ito",32,Japan,2008,Softball,1,0,0,1
"Lovie Jung",28,"United States",2008,Softball,0,1,0,1
"Ayumi Karino",23,Japan,2008,Softball,1,0,0,1
"Kelly Kretschman",28,"United States",2008,Softball,0,1,0,1
"Lauren Lappin",24,"United States",2008,Softball,0,1,0,1
"Caitlin Lowe",23,"United States",2008,Softball,0,1,0,1
"Satoko Mabuchi",26,Japan,2008,Softball,1,0,0,1
"Jessica Mendoza",27,"United States",2008,Softball,0,1,0,1
"Yukiyo Mine",20,Japan,2008,Softball,1,0,0,1
"Masumi Mishina",26,Japan,2008,Softball,1,0,0,1
"Simmone Morrow",31,Australia,2008,Softball,0,0,1,1
"Tracey Mosley",34,Australia,2008,Softball,0,0,1,1
"Rei Nishiyama",24,Japan,2008,Softball,1,0,0,1
"Stacey Nuveman",30,"United States",2008,Softball,0,1,0,1
"Cat Osterman",25,"United States",2008,Softball,0,1,0,1
"Stacey Porter",26,Australia,2008,Softball,0,0,1,1
"Melanie Roche",37,Australia,2008,Softball,0,0,1,1
"Hiroko Sakai",29,Japan,2008,Softball,1,0,0,1
"Rie Sato",27,Japan,2008,Softball,1,0,0,1
"Justine Smethurst",21,Australia,2008,Softball,0,0,1,1
"Mika Someya",25,Japan,2008,Softball,1,0,0,1
"Danielle Stewart",27,Australia,2008,Softball,0,0,1,1
"Natalie Titcume",32,Australia,2008,Softball,0,0,1,1
"Yukiko Ueno",26,Japan,2008,Softball,1,0,0,1
"Natalie Ward",32,Australia,2008,Softball,0,0,1,1
"Natasha Watley",26,"United States",2008,Softball,0,1,0,1
"Belinda Wright",27,Australia,2008,Softball,0,0,1,1
"Kerry Wyborn",30,Australia,2008,Softball,0,0,1,1
"Eri Yamada",24,Japan,2008,Softball,1,0,0,1
"Artur Aivazian",35,Ukraine,2008,Shooting,1,0,0,1
"Aleksey Alipov",33,Russia,2008,Shooting,0,0,1,1
"Abhinav Bindra",25,India,2008,Shooting,1,0,0,1
"Christine Brinker-Wenzel",27,Germany,2008,Shooting,0,0,1,1
"Tore Brovold",38,Norway,2008,Shooting,0,1,0,1
"Chiara Cainero",30,Italy,2008,Shooting,1,0,0,1
"Chen Ying",30,China,2008,Shooting,1,0,0,1
"Corey Cogdell",21,"United States",2008,Shooting,0,0,1,1
"Eglis Yaima Cruz",28,Cuba,2008,Shooting,0,0,1,1
"Francesco D'Aniello",39,Italy,2008,Shooting,0,1,0,1
"Rajmond Debevec",45,Slovenia,2008,Shooting,0,0,1,1
"Munkhbayar Dorjsuren",39,Germany,2008,Shooting,0,0,1,1
"Du Li",26,China,2008,Shooting,1,0,0,1
"Glenn Eller",26,"United States",2008,Shooting,1,0,0,1
"Matt Emmons",27,"United States",2008,Shooting,0,1,0,1
"Lyubov Galkina",35,Russia,2008,Shooting,0,1,0,1
"Guo Wenjun",24,China,2008,Shooting,1,0,0,1
"Henri Häkkinen",28,Finland,2008,Shooting,0,0,1,1
"Vincent Hancock",19,"United States",2008,Shooting,1,0,0,1
"Hu Binyuan",30,China,2008,Shooting,0,0,1,1
"Vladimir Isakov",38,Russia,2008,Shooting,0,0,1,1
"David Kostelecký",33,"Czech Republic",2008,Shooting,1,0,0,1
"Satu Mäkelä-Nummela",37,Finland,2008,Shooting,1,0,0,1
"Otryadyn Gündegmaa",30,Mongolia,2008,Shooting,0,1,0,1
"Nataliya Paderina",32,Russia,2008,Shooting,0,1,0,1
"Pang Wei",22,China,2008,Shooting,1,0,0,1
"Snježana Pejcic",26,Croatia,2008,Shooting,0,0,1,1
"Giovanni Pellielo",38,Italy,2008,Shooting,0,1,0,1
"Oleksandr Petriv",34,Ukraine,2008,Shooting,1,0,0,1
"Warren Potent",46,Australia,2008,Shooting,0,0,1,1
"Qiu Jian",33,China,2008,Shooting,1,0,0,1
"Christian Reitz",21,Germany,2008,Shooting,0,0,1,1
"Kim Rhode",29,"United States",2008,Shooting,0,1,0,1
"Nino Salukvadze",39,Georgia,2008,Shooting,0,0,1,1
"Ralf Schumann",46,Germany,2008,Shooting,0,1,0,1
"Zuzana Štefeceková",24,Slovakia,2008,Shooting,0,1,0,1
"Yuriy Sukhorukov",40,Ukraine,2008,Shooting,0,1,0,1
"Tan Zongliang",36,China,2008,Shooting,0,1,0,1
"Anthony Terras",23,France,2008,Shooting,0,0,1,1
"Jason Turner",33,"United States",2008,Shooting,0,0,1,1
"Zhu Qinan",23,China,2008,Shooting,0,1,0,1
"Ben Ainslie",31,"Great Britain",2008,Sailing,1,0,0,1
"Glenn Ashby",30,Australia,2008,Sailing,0,1,0,1
"Tom Ashley",24,"New Zealand",2008,Sailing,1,0,0,1
"Sarah Ayton",28,"Great Britain",2008,Sailing,1,0,0,1
"Olivier Bausset",26,France,2008,Sailing,0,0,1,1
"Sofia Bekatorou",30,Greece,2008,Sailing,0,0,1,1
"Lobke Berkhout",27,Netherlands,2008,Sailing,0,1,0,1
"Annemieke Bes",30,Netherlands,2008,Sailing,0,1,0,1
"Julien Bontemps",29,France,2008,Sailing,0,1,0,1
"Marcelien Bos-de Koning",30,Netherlands,2008,Sailing,0,1,0,1
"Darren Bundock",37,Australia,2008,Sailing,0,1,0,1
"Nicolas Charbonnier",27,France,2008,Sailing,0,0,1,1
"Fernando Echavarri",36,Spain,2008,Sailing,1,0,0,1
"Anders Ekström",27,Sweden,2008,Sailing,0,0,1,1
"Carlos Espínola",36,Argentina,2008,Sailing,0,0,1,1
"Xavier Fernández",31,Spain,2008,Sailing,0,1,0,1
"Guillaume Florent",34,France,2008,Sailing,0,0,1,1
"Joe Glanfield",29,"Great Britain",2008,Sailing,0,1,0,1
"Paul Goodison",30,"Great Britain",2008,Sailing,1,0,0,1
"Martin Kirketerp",36,Denmark,2008,Sailing,1,0,0,1
"Virginia Kravarioti",24,Greece,2008,Sailing,0,0,1,1
"Santiago Lange",46,Argentina,2008,Sailing,0,0,1,1
"Fredrik Lööf",38,Sweden,2008,Sailing,0,0,1,1
"Iker Martínez",31,Spain,2008,Sailing,0,1,0,1
"Mandy Mulder",21,Netherlands,2008,Sailing,0,1,0,1
"Fernanda Oliveira",27,Brazil,2008,Sailing,0,0,1,1
"Malcolm Page",36,Australia,2008,Sailing,1,0,0,1
"Sofia Papadopoulou",24,Greece,2008,Sailing,0,0,1,1
"Tessa Parkinson",21,Australia,2008,Sailing,1,0,0,1
"Antón Paz",32,Spain,2008,Sailing,1,0,0,1
"Hannes Peckolt",25,Germany,2008,Sailing,0,0,1,1
"Jan Peter Peckolt",27,Germany,2008,Sailing,0,0,1,1
"Iain Percy",32,"Great Britain",2008,Sailing,1,0,0,1
"Bruno Prada",37,Brazil,2008,Sailing,0,1,0,1
"Zach Railey",24,"United States",2008,Sailing,0,1,0,1
"Elise Rechichi",22,Australia,2008,Sailing,1,0,0,1
"Nick Rogers",31,"Great Britain",2008,Sailing,0,1,0,1
"Diego Romero",33,Italy,2008,Sailing,0,0,1,1
"Robert Scheidt",35,Brazil,2008,Sailing,0,1,0,1
"Alessandra Sensini",38,Italy,2008,Sailing,0,1,0,1
"Bryony Shaw",25,"Great Britain",2008,Sailing,0,0,1,1
"Andrew Simpson",31,"Great Britain",2008,Sailing,1,0,0,1
"Isabel Swan",24,Brazil,2008,Sailing,0,0,1,1
"Anna Tunnicliffe",25,"United States",2008,Sailing,1,0,0,1
"Gintare Volungeviciute-Scheidt",25,Lithuania,2008,Sailing,0,1,0,1
"Jonas Warrer",29,Denmark,2008,Sailing,1,0,0,1
"Sarah Webb",31,"Great Britain",2008,Sailing,1,0,0,1
"Nathan Wilmot",28,Australia,2008,Sailing,1,0,0,1
"Pippa Wilson",22,"Great Britain",2008,Sailing,1,0,0,1
"Merel Witteveen",23,Netherlands,2008,Sailing,0,1,0,1
"Xu Lijia",20,China,2008,Sailing,0,0,1,1
"Yin Jian",29,China,2008,Sailing,1,0,0,1
"Vasilij Žbogar",32,Slovenia,2008,Sailing,0,1,0,1
"Shahar Zubari",21,Israel,2008,Sailing,0,0,1,1
"Luca Agamennoni",28,Italy,2008,Rowing,0,1,0,1
"Wyatt Allen",29,"United States",2008,Rowing,0,0,1,1
"Mads Andersen",30,Denmark,2008,Rowing,1,0,0,1
"Julien Bahain",22,France,2008,Rowing,0,0,1,1
"Eniko Barabas-Mironcic",22,Romania,2008,Rowing,0,0,1,1
"Jon Beare",34,Canada,2008,Rowing,0,0,1,1
"Anna Bebington-Watkins",25,"Great Britain",2008,Rowing,0,0,1,1
"Milosz Bernatajtys",26,Poland,2008,Rowing,0,1,0,1
"Cédric Berrest",23,France,2008,Rowing,0,0,1,1
"Yuliya Bichik",25,Belarus,2008,Rowing,0,0,1,1
"Kathrin Boron",38,Germany,2008,Rowing,0,0,1,1
"Micah Boyd",26,"United States",2008,Rowing,0,0,1,1
"Iain Brambell",34,Canada,2008,Rowing,0,0,1,1
"Scott Brennan",25,Australia,2008,Rowing,1,0,0,1
"George Bridgewater",25,"New Zealand",2008,Rowing,0,0,1,1
"Andrew Byrnes",25,Canada,2008,Rowing,1,0,0,1
"Erin Cafaro",25,"United States",2008,Rowing,1,0,0,1
"Dave Calder",30,Canada,2008,Rowing,0,1,0,1
"Tracy Cameron",33,Canada,2008,Rowing,0,0,1,1
"Germain Chardin",25,France,2008,Rowing,0,0,1,1
"Jonathan Coeffic",27,France,2008,Rowing,0,0,1,1
"Steven Coppola",24,"United States",2008,Rowing,0,0,1,1
"David Crawshay",28,Australia,2008,Rowing,1,0,0,1
"Caryn Davies",26,"United States",2008,Rowing,1,0,0,1
"Annemiek de Haan",27,Netherlands,2008,Rowing,0,1,0,1
"Femke Dekker",29,Netherlands,2008,Rowing,0,1,0,1
"Julien Després",25,France,2008,Rowing,0,0,1,1
"Mahé Drysdale",29,"New Zealand",2008,Rowing,0,0,1,1
"Rumyana Dzhadzharova-Neykova",35,Bulgaria,2008,Rowing,1,0,0,1
"Eskild Ebbesen",36,Denmark,2008,Rowing,1,0,0,1
"Thomas Ebert",35,Denmark,2008,Rowing,1,0,0,1
"Ric Egington",29,"Great Britain",2008,Rowing,0,1,0,1
"Tõnu Endrekson",29,Estonia,2008,Rowing,0,1,0,1
"Caroline Evers-Swindell",29,"New Zealand",2008,Rowing,1,0,0,1
"Georgina Evers-Swindell",29,"New Zealand",2008,Rowing,1,0,0,1
"Debbie Flood",28,"Great Britain",2008,Rowing,0,1,0,1
"Rodica Florea-Serban",25,Romania,2008,Rowing,0,0,1,1
"Susan Francia",25,"United States",2008,Rowing,1,0,0,1
"Scott Frandsen",28,Canada,2008,Rowing,0,1,0,1
"Duncan Free",35,Australia,2008,Rowing,1,0,0,1
"Rossano Galtarossa",36,Italy,2008,Rowing,0,1,0,1
"Gao Yulan",24,China,2008,Rowing,0,1,0,1
"Nataliya Gelakh",30,Belarus,2008,Rowing,0,0,1,1
"Elena Georgescu",44,Romania,2008,Rowing,0,0,1,1
"Drew Ginn",33,Australia,2008,Rowing,1,0,0,1
"Anna Goodale",25,"United States",2008,Rowing,1,0,0,1
"Katherine Grainger",32,"Great Britain",2008,Rowing,0,1,0,1
"Michelle Guerette",27,"United States",2008,Rowing,0,1,0,1
"Kyle Hamilton",30,Canada,2008,Rowing,1,0,0,1
"Alastair Heathcote",30,"Great Britain",2008,Rowing,0,1,0,1
"Francis Hegerty",25,Australia,2008,Rowing,0,1,0,1
"Beau Hoopman",27,"United States",2008,Rowing,0,0,1,1
"Frances Houghton",27,"Great Britain",2008,Rowing,0,1,0,1
"Malcolm Howard",25,Canada,2008,Rowing,1,0,0,1
"Mark Hunter",30,"Great Britain",2008,Rowing,1,0,0,1
"Christiane Huth",27,Germany,2008,Rowing,0,1,0,1
"Doina Ignat",39,Romania,2008,Rowing,0,0,1,1
"Josh Inman",28,"United States",2008,Rowing,0,0,1,1
"Jüri Jaanson",42,Estonia,2008,Rowing,0,1,0,1
"Tom James",24,"Great Britain",2008,Rowing,1,0,0,1
"Michal Jelinski",28,Poland,2008,Rowing,1,0,0,1
"Jin Ziwei",22,China,2008,Rowing,1,0,0,1
"Morten Jørgensen",23,Denmark,2008,Rowing,1,0,0,1
"Yekaterina Khodatovich-Karsten",36,Belarus,2008,Rowing,0,0,1,1
"Nienke Kingma",26,Netherlands,2008,Rowing,0,1,0,1
"Melanie Kok",24,Canada,2008,Rowing,0,0,1,1
"Marek Kolbowicz",37,Poland,2008,Rowing,1,0,0,1
"Adam Korol",33,Poland,2008,Rowing,1,0,0,1
"Adam Kreek",27,Canada,2008,Rowing,1,0,0,1
"Matt Langridge",25,"Great Britain",2008,Rowing,0,1,0,1
"Elise Laverick",33,"Great Britain",2008,Rowing,0,0,1,1
"Mike Lewis",27,Canada,2008,Rowing,0,0,1,1
"Kevin Light",29,Canada,2008,Rowing,1,0,0,1
"Caroline Lind",25,"United States",2008,Rowing,1,0,0,1
"Elle Logan",20,"United States",2008,Rowing,1,0,0,1
"Tom Lucy",20,"Great Britain",2008,Rowing,0,1,0,1
"Manuela Lutze",34,Germany,2008,Rowing,0,0,1,1
"James Marburg",25,Australia,2008,Rowing,0,1,0,1
"Marcus McElhenney",27,"United States",2008,Rowing,0,0,1,1
"Maxi McKenzie-McHarg",28,Australia,2008,Rowing,0,1,0,1
"Anna Mickelson-Cummins",28,"United States",2008,Rowing,1,0,0,1
"Dorian Mortelette",24,France,2008,Rowing,0,0,1,1
"Dimitris Mougios",26,Greece,2008,Rowing,0,1,0,1
"Acer Nethercott",30,"Great Britain",2008,Rowing,0,1,0,1
"Minna Nieminen",31,Finland,2008,Rowing,0,1,0,1
"Britta Oppelt",30,Germany,2008,Rowing,0,0,1,1
"Ioana Papuc-Rotaru",24,Romania,2008,Rowing,0,0,1,1
"Liam Parsons",31,Canada,2008,Rowing,0,0,1,1
"Alex Partridge",27,"Great Britain",2008,Rowing,0,1,0,1
"Bartlomiej Pawelczak",26,Poland,2008,Rowing,0,1,0,1
"Lukasz Pawlowski",25,Poland,2008,Rowing,0,1,0,1
"Pierre-Jean Peltier",24,France,2008,Rowing,0,0,1,1
"Constanta Pipota-Burcica",37,Romania,2008,Rowing,0,0,1,1
"Vasilios Polymeros",32,Greece,2008,Rowing,0,1,0,1
"Brian Price",32,Canada,2008,Rowing,1,0,0,1
"Zac Purchase",22,"Great Britain",2008,Rowing,1,0,0,1
"Rasmus Quist",28,Denmark,2008,Rowing,0,0,1,1
"Simone Raineri",31,Italy,2008,Rowing,0,1,0,1
"Pawel Randa",29,Poland,2008,Rowing,0,1,0,1
"Mads Rasmussen",26,Denmark,2008,Rowing,0,0,1,1
"Pete Reed",27,"Great Britain",2008,Rowing,1,0,0,1
"Roline Repelaer van Driel",24,Netherlands,2008,Rowing,0,1,0,1
"Benjamin Rondeau",24,France,2008,Rowing,0,0,1,1
"Stephen Rowbotham",26,"Great Britain",2008,Rowing,0,0,1,1
"Ben Rutledge",27,Canada,2008,Rowing,1,0,0,1
"Matt Ryan",24,Australia,2008,Rowing,0,1,0,1
"Stephanie Schiller",22,Germany,2008,Rowing,0,0,1,1
"Matt Schnobrich",29,"United States",2008,Rowing,0,0,1,1
"Lindsay Schoop",26,"United States",2008,Rowing,1,0,0,1
"Dominic Seiterle",32,Canada,2008,Rowing,1,0,0,1
"Sarah Siegelaar",26,Netherlands,2008,Rowing,0,1,0,1
"Colin Smith",24,"Great Britain",2008,Rowing,0,1,0,1
"Marlies Smulders",26,Netherlands,2008,Rowing,0,1,0,1
"Tom Stallard",29,"Great Britain",2008,Rowing,0,1,0,1
"Sanna Stén",31,Finland,2008,Rowing,0,1,0,1
"Simona Strimbeschi-Musat",26,Romania,2008,Rowing,0,0,1,1
"Ondrej Synek",25,"Czech Republic",2008,Rowing,0,1,0,1
"Tang Bin",22,China,2008,Rowing,1,0,0,1
"Helen Tanger",29,Netherlands,2008,Rowing,0,1,0,1
"Annekatrin Thiele",23,Germany,2008,Rowing,0,1,0,1
"Andrew Triggs Hodge",29,"Great Britain",2008,Rowing,1,0,0,1
"Olaf Tufte",32,Norway,2008,Rowing,1,0,0,1
"Nathan Twaddle",31,"New Zealand",2008,Rowing,0,0,1,1
"Kirsten van der Kolk",32,Netherlands,2008,Rowing,1,0,0,1
"Marit van Eupen",38,Netherlands,2008,Rowing,1,0,0,1
"Annemarieke van Rumpt",28,Netherlands,2008,Rowing,0,1,0,1
"Simone Venier",23,Italy,2008,Rowing,0,1,0,1
"Annie Vernon",25,"Great Britain",2008,Rowing,0,1,0,1
"Bryan Volpenhein",31,"United States",2008,Rowing,0,0,1,1
"Daniel Walsh",29,"United States",2008,Rowing,0,0,1,1
"Konrad Wasielewski",23,Poland,2008,Rowing,1,0,0,1
"Matt Wells",28,"Great Britain",2008,Rowing,0,0,1,1
"Josh West",31,"Great Britain",2008,Rowing,0,1,0,1
"Jake Wetzel",31,Canada,2008,Rowing,1,0,0,1
"Mary Whipple",28,"United States",2008,Rowing,1,0,0,1
"Steve Williams",32,"Great Britain",2008,Rowing,1,0,0,1
"Ester Workel",33,Netherlands,2008,Rowing,0,1,0,1
"Wu You",24,China,2008,Rowing,0,1,0,1
"Xi Aihua",26,China,2008,Rowing,1,0,0,1
"Zhang Yangyang",19,China,2008,Rowing,1,0,0,1
"Margarita Aliychuk",18,Russia,2008,"Rhythmic Gymnastics",1,0,0,1
"Alesya Babushkina",19,Belarus,2008,"Rhythmic Gymnastics",0,0,1,1
"Hanna Bezsonova",24,Ukraine,2008,"Rhythmic Gymnastics",0,0,1,1
"Cai Tongtong",18,China,2008,"Rhythmic Gymnastics",0,1,0,1
"Chou Tao",20,China,2008,"Rhythmic Gymnastics",0,1,0,1
"Anna Gavrilenko",18,Russia,2008,"Rhythmic Gymnastics",1,0,0,1
"Tatyana Gorbunova",18,Russia,2008,"Rhythmic Gymnastics",1,0,0,1
"Anastasiya Ivankova",16,Belarus,2008,"Rhythmic Gymnastics",0,0,1,1
"Yevgeniya Kanayeva",18,Russia,2008,"Rhythmic Gymnastics",1,0,0,1
"Lu Yuanyang",25,China,2008,"Rhythmic Gymnastics",0,1,0,1
"Zina Lunina",19,Belarus,2008,"Rhythmic Gymnastics",0,0,1,1
"Glafira Martinovich",19,Belarus,2008,"Rhythmic Gymnastics",0,0,1,1
"Yelena Posevina",22,Russia,2008,"Rhythmic Gymnastics",1,0,0,1
"Kseniya Sankovich",18,Belarus,2008,"Rhythmic Gymnastics",0,0,1,1
"Darya Shkurikhina",17,Russia,2008,"Rhythmic Gymnastics",1,0,0,1
"Sui Jianshuang",19,China,2008,"Rhythmic Gymnastics",0,1,0,1
"Sun Dan",21,China,2008,"Rhythmic Gymnastics",0,1,0,1
"Alina Tumilovich",18,Belarus,2008,"Rhythmic Gymnastics",0,0,1,1
"Zhang Shuo",24,China,2008,"Rhythmic Gymnastics",0,1,0,1
"Inna Zhukova",21,Belarus,2008,"Rhythmic Gymnastics",0,1,0,1
"Nataliya Zuyeva",19,Russia,2008,"Rhythmic Gymnastics",1,0,0,1
"Heather Fell",25,"Great Britain",2008,"Modern Pentathlon",0,1,0,1
"Edvinas Krungolcas",35,Lithuania,2008,"Modern Pentathlon",0,1,0,1
"Andrey Moiseyev",29,Russia,2008,"Modern Pentathlon",1,0,0,1
"Lena Schöneborn",22,Germany,2008,"Modern Pentathlon",1,0,0,1
"Viktoriya Tereshchuk",26,Ukraine,2008,"Modern Pentathlon",0,0,1,1
"Andrejus Zadneprovskis",33,Lithuania,2008,"Modern Pentathlon",0,0,1,1
"An Kum-Ae",28,"North Korea",2008,Judo,0,1,0,1
"Yordanis Arencibia",28,Cuba,2008,Judo,0,0,1,1
"Sergei Aschwanden",32,Switzerland,2008,Judo,0,0,1,1
"Amar Benikhlef",26,Algeria,2008,Judo,0,1,0,1
"Yanet Bermoy",21,Cuba,2008,Judo,0,1,0,1
"Ole Bischof",28,Germany,2008,Judo,1,0,0,1
"Rasul Bokiyev",25,Tajikistan,2008,Judo,0,0,1,1
"Edith Bosch",28,Netherlands,2008,Judo,0,0,1,1
"Oscar Braison",23,Cuba,2008,Judo,0,0,1,1
"Tiago Camilo",26,Brazil,2008,Judo,0,0,1,1
"Yalennis Castillo",22,Cuba,2008,Judo,0,1,0,1
"Choi Min-Ho",27,"South Korea",2008,Judo,1,0,0,1
"Benjamin Darbelet",27,France,2008,Judo,0,1,0,1
"Lucie Décosse",27,France,2008,Judo,0,1,0,1
"Alina Dumitru",25,Romania,2008,Judo,1,0,0,1
"Deborah Gravenstijn",33,Netherlands,2008,Judo,0,1,0,1
"Henk Grol",23,Netherlands,2008,Judo,0,0,1,1
"Leandro Guilheiro",25,Brazil,2008,Judo,0,0,1,1
"Soraya Haddad",23,Algeria,2008,Judo,0,0,1,1
"Anaisis Hernández",26,Cuba,2008,Judo,0,1,0,1
"Roman Hontiuk",24,Ukraine,2008,Judo,0,0,1,1
"Ruben Houkes",29,Netherlands,2008,Judo,0,0,1,1
"Satoshi Ishii",21,Japan,2008,Judo,1,0,0,1
"Jeong Gyeong-Mi",23,"South Korea",2008,Judo,0,0,1,1
"Kim Jae-Beom",23,"South Korea",2008,Judo,0,1,0,1
"Mövlud Mir?liyev",34,Azerbaijan,2008,Judo,0,0,1,1
"Hesham Misbah",26,Egypt,2008,Judo,0,0,1,1
"Elnur M?mm?dli",20,Azerbaijan,2008,Judo,1,0,0,1
"Naidangiin Tüvshinbayar",24,Mongolia,2008,Judo,1,0,0,1
"Misato Nakamura",19,Japan,2008,Judo,0,0,1,1
"Idalys Ortíz",18,Cuba,2008,Judo,0,0,1,1
"Ludwig Paischer",26,Austria,2008,Judo,0,1,0,1
"Pak Chol-Min",25,"North Korea",2008,Judo,0,0,1,1
"Paula Pareto",22,Argentina,2008,Judo,0,0,1,1
"Lucija Polavder",23,Slovenia,2008,Judo,0,0,1,1
"Stéphanie Possamai",28,France,2008,Judo,0,0,1,1
"Ketleyn Quadros",20,Brazil,2008,Judo,0,0,1,1
"Giulia Quintavalle",25,Italy,2008,Judo,1,0,0,1
"Teddy Riner",19,France,2008,Judo,0,0,1,1
"Ronda Rousey",21,"United States",2008,Judo,0,0,1,1
"Rishod Sobirov",21,Uzbekistan,2008,Judo,0,0,1,1
"Ryoko Tamura-Tani",32,Japan,2008,Judo,0,0,1,1
"Abdullo Tangriyev",27,Uzbekistan,2008,Judo,0,1,0,1
"Ayumi Tanimoto",27,Japan,2008,Judo,1,0,0,1
"Tong Wen",25,China,2008,Judo,1,0,0,1
"Irakli Tsirekidze",26,Georgia,2008,Judo,1,0,0,1
"Maki Tsukada",26,Japan,2008,Judo,0,1,0,1
"Masato Uchishiba",30,Japan,2008,Judo,1,0,0,1
"Masae Ueno",29,Japan,2008,Judo,1,0,0,1
"Wang Gi-Chun",19,"South Korea",2008,Judo,0,1,0,1
"Elisabeth Willeboordse",29,Netherlands,2008,Judo,0,0,1,1
"Won Ok-Im",21,"North Korea",2008,Judo,0,0,1,1
"Xian Dongmei",32,China,2008,Judo,1,0,0,1
"Xu Yan",26,China,2008,Judo,0,0,1,1
"Yang Xiuli",24,China,2008,Judo,1,0,0,1
"Askhat Zhitkeyev",27,Kazakhstan,2008,Judo,0,1,0,1
"Des Abbott",21,Australia,2008,Hockey,0,0,1,1
"Marilyn Agliotti",29,Netherlands,2008,Hockey,1,0,0,1
"Magdalena Aicega",34,Argentina,2008,Hockey,0,0,1,1
"David Alegre",23,Spain,2008,Hockey,0,1,0,1
"Ramón Alegre",27,Spain,2008,Hockey,0,1,0,1
"Pol Amat",30,Spain,2008,Hockey,0,1,0,1
"Eduard Arbós",25,Spain,2008,Hockey,0,1,0,1
"Lucha Aymar",31,Argentina,2008,Hockey,0,0,1,1
"Noel Barrionuevo",24,Argentina,2008,Hockey,0,0,1,1
"Sebastian Biederlack",26,Germany,2008,Hockey,1,0,0,1
"Minke Booij",31,Netherlands,2008,Hockey,1,0,0,1
"Travis Brooks",28,Australia,2008,Hockey,0,0,1,1
"Kiel Brown",24,Australia,2008,Hockey,0,0,1,1
"Claudia Burkart",28,Argentina,2008,Hockey,0,0,1,1
"Chen Qiuqi",28,China,2008,Hockey,0,1,0,1
"Chen Zhaoxia",33,China,2008,Hockey,0,1,0,1
"Cheng Hui",35,China,2008,Hockey,0,1,0,1
"Quico Cortés",25,Spain,2008,Hockey,0,1,0,1
"Eva de Goede",19,Netherlands,2008,Hockey,1,0,0,1
"Lisanne de Roever",29,Netherlands,2008,Hockey,1,0,0,1
"Liam De Young",26,Australia,2008,Hockey,0,0,1,1
"Wieke Dijkstra",24,Netherlands,2008,Hockey,1,0,0,1
"Luke Doerner",28,Australia,2008,Hockey,0,0,1,1
"Jamie Dwyer",29,Australia,2008,Hockey,0,0,1,1
"Sergi Enrique",20,Spain,2008,Hockey,0,1,0,1
"Alex Fábregas",27,Spain,2008,Hockey,0,1,0,1
"Kiko Fábregas",30,Spain,2008,Hockey,0,1,0,1
"Juan Fernández",23,Spain,2008,Hockey,0,1,0,1
"Santi Freixa",25,Spain,2008,Hockey,0,1,0,1
"Fu Baorong",30,China,2008,Hockey,0,1,0,1
"Moritz Fürste",23,Germany,2008,Hockey,1,0,0,1
"Gao Lihua",28,China,2008,Hockey,0,1,0,1
"Sole García",27,Argentina,2008,Hockey,0,0,1,1
"Rodrigo Garza",28,Spain,2008,Hockey,0,1,0,1
"Bevan George",31,Australia,2008,Hockey,0,0,1,1
"Maartje Goderie",24,Netherlands,2008,Hockey,1,0,0,1
"Mariana González",32,Argentina,2008,Hockey,0,0,1,1
"David Guest",26,Australia,2008,Hockey,0,0,1,1
"Alejandra Gulla",31,Argentina,2008,Hockey,0,0,1,1
"Rob Hammond",27,Australia,2008,Hockey,0,0,1,1
"Tobias Hauke",20,Germany,2008,Hockey,1,0,0,1
"Maripi Hernández",31,Argentina,2008,Hockey,0,0,1,1
"Ellen Hoog",22,Netherlands,2008,Hockey,1,0,0,1
"Huang Junxia",32,China,2008,Hockey,0,1,0,1
"Gisi Kañevsky",23,Argentina,2008,Hockey,0,0,1,1
"Fergus Kavanagh",23,Australia,2008,Hockey,0,0,1,1
"Florian Keller",26,Germany,2008,Hockey,1,0,0,1
"Mark Knowles",23,Australia,2008,Hockey,0,0,1,1
"Oliver Korn",24,Germany,2008,Hockey,1,0,0,1
"Stephen Lambert",28,Australia,2008,Hockey,0,0,1,1
"Li Hongxia",21,China,2008,Hockey,0,1,0,1
"Li Shuang",30,China,2008,Hockey,0,1,0,1
"Rosario Luchetti",24,Argentina,2008,Hockey,0,0,1,1
"Ma Yibo",28,China,2008,Hockey,0,1,0,1
"Mechi Margalot",33,Argentina,2008,Hockey,0,0,1,1
"Eli Matheson",25,Australia,2008,Hockey,0,0,1,1
"Niklas Meinert",27,Germany,2008,Hockey,1,0,0,1
"Jan-Marco Montag",24,Germany,2008,Hockey,1,0,0,1
"Fátima Moreira de Melo",30,Netherlands,2008,Hockey,1,0,0,1
"Eefke Mulder",30,Netherlands,2008,Hockey,1,0,0,1
"Max Müller",21,Germany,2008,Hockey,1,0,0,1
"Carlos Nevado",25,Germany,2008,Hockey,1,0,0,1
"Eddie Ockenden",21,Australia,2008,Hockey,0,0,1,1
"Roc Oliva",19,Spain,2008,Hockey,0,1,0,1
"Pan Fengzhen",23,China,2008,Hockey,0,1,0,1
"Maartje Paumen",22,Netherlands,2008,Hockey,1,0,0,1
"Sophie Polkamp",24,Netherlands,2008,Hockey,1,0,0,1
"Carla Rebecchi",23,Argentina,2008,Hockey,0,0,1,1
"Ren Ye",22,China,2008,Hockey,0,1,0,1
"Xavier Ribas",32,Spain,2008,Hockey,0,1,0,1
"Mariana Rossi",29,Argentina,2008,Hockey,0,0,1,1
"Mariné Russo",28,Argentina,2008,Hockey,0,0,1,1
"Albert Sala",27,Spain,2008,Hockey,0,1,0,1
"Janneke Schopman",31,Netherlands,2008,Hockey,1,0,0,1
"Grant Schubert",28,Australia,2008,Hockey,0,0,1,1
"Minke Smabers",29,Netherlands,2008,Hockey,1,0,0,1
"Andrew Smith",29,Australia,2008,Hockey,0,0,1,1
"Víctor Sojo",24,Spain,2008,Hockey,0,1,0,1
"Song Qingling",22,China,2008,Hockey,0,1,0,1
"Belén Succi",22,Argentina,2008,Hockey,0,0,1,1
"Tang Chunling",32,China,2008,Hockey,0,1,0,1
"Eddie Tubau",27,Spain,2008,Hockey,0,1,0,1
"Naomi van As",25,Netherlands,2008,Hockey,1,0,0,1
"Miek van Geenhuizen",26,Netherlands,2008,Hockey,1,0,0,1
"Paola Vukojicic",33,Argentina,2008,Hockey,0,0,1,1
"Max Weinhold",26,Germany,2008,Hockey,1,0,0,1
"Tibor Weißenborn",27,Germany,2008,Hockey,1,0,0,1
"Matt Wells",30,Australia,2008,Hockey,0,0,1,1
"Lidewij Welten",18,Netherlands,2008,Hockey,1,0,0,1
"Benjamin Weß",23,Germany,2008,Hockey,1,0,0,1
"Timo Weß",26,Germany,2008,Hockey,1,0,0,1
"Philip Witte",24,Germany,2008,Hockey,1,0,0,1
"Matthias Witthaus",26,Germany,2008,Hockey,1,0,0,1
"Christopher Zeller",23,Germany,2008,Hockey,1,0,0,1
"Philipp Zeller",25,Germany,2008,Hockey,1,0,0,1
"Zhang Yimeng",24,China,2008,Hockey,0,1,0,1
"Zhao Yudiao",19,China,2008,Hockey,0,1,0,1
"Zhou Wanfeng",28,China,2008,Hockey,0,1,0,1
"Ragnhild Aamodt",27,Norway,2008,Handball,1,0,0,1
"Luc Abalo",23,France,2008,Handball,1,0,0,1
"Joël Abati",37,France,2008,Handball,1,0,0,1
"An Jeong-Hwa",27,"South Korea",2008,Handball,0,0,1,1
"Yekaterina Andryushina",22,Russia,2008,Handball,0,1,0,1
"Sturla Ásgeirsson",28,Iceland,2008,Handball,0,1,0,1
"Arnór Atlason",24,Iceland,2008,Handball,0,1,0,1
"Bae Min-Hee",20,"South Korea",2008,Handball,0,0,1,1
"David Barrufet",38,Spain,2008,Handball,0,0,1,1
"Jon Belaustegui",29,Spain,2008,Handball,0,0,1,1
"Inna Bliznova",21,Russia,2008,Handball,0,1,0,1
"Karoline Dyhre Breivang",28,Norway,2008,Handball,1,0,0,1
"Cédric Burdet",33,France,2008,Handball,1,0,0,1
"Choi Im-Jeong",27,"South Korea",2008,Handball,0,0,1,1
"David Davis",31,Spain,2008,Handball,0,0,1,1
"Didier Dinart",31,France,2008,Handball,1,0,0,1
"Yelena Dmitriyeva",25,Russia,2008,Handball,0,1,0,1
"Alberto Entrerríos",31,Spain,2008,Handball,0,0,1,1
"Raúl Entrerríos",27,Spain,2008,Handball,0,0,1,1
"Jérôme Fernandez",31,France,2008,Handball,1,0,0,1
"Marit Malm Frafjord",22,Norway,2008,Handball,1,0,0,1
"Rubén Garabaya",29,Spain,2008,Handball,0,0,1,1
"Juan García",30,Spain,2008,Handball,0,0,1,1
"Logi Geirsson",25,Iceland,2008,Handball,0,1,0,1
"Bertrand Gille",30,France,2008,Handball,1,0,0,1
"Guillaume Gille",32,France,2008,Handball,1,0,0,1
"Olivier Girault",35,France,2008,Handball,1,0,0,1
"Kari Aalvik Grimsbø",23,Norway,2008,Handball,1,0,0,1
"Michaël Guigou",26,France,2008,Handball,1,0,0,1
"Róbert Gunnarsson",28,Iceland,2008,Handball,0,1,0,1
"Björgvin Gustavsson",23,Iceland,2008,Handball,0,1,0,1
"Snorri Guðjónsson",26,Iceland,2008,Handball,0,1,0,1
"Hreiðar Guðmundsson",27,Iceland,2008,Handball,0,1,0,1
"Ásgeir Örn Hallgrímsson",24,Iceland,2008,Handball,0,1,0,1
"Gro Hammerseng",28,Norway,2008,Handball,1,0,0,1
"Katrine Lunde Haraldsen",28,Norway,2008,Handball,1,0,0,1
"Heo Sun-Yeong",32,"South Korea",2008,Handball,0,0,1,1
"José Javier Hombrados",36,Spain,2008,Handball,0,0,1,1
"Hong Jeong-Ho",34,"South Korea",2008,Handball,0,0,1,1
"Ingimundur Ingimundarson",28,Iceland,2008,Handball,0,1,0,1
"Sverre Jakobsson",31,Iceland,2008,Handball,0,1,0,1
"Kari Mette Johansen",29,Norway,2008,Handball,1,0,0,1
"Nikola Karabatic",24,France,2008,Handball,1,0,0,1
"Daouda Karaboué",32,France,2008,Handball,1,0,0,1
"Anna Kareyeva",31,Russia,2008,Handball,0,1,0,1
"Christophe Kempé",33,France,2008,Handball,1,0,0,1
"Kim Cha-Yeon",27,"South Korea",2008,Handball,0,0,1,1
"Kim Nam-Sun",27,"South Korea",2008,Handball,0,0,1,1
"Kim On-A",19,"South Korea",2008,Handball,0,0,1,1
"Tonje Larsen",33,Norway,2008,Handball,1,0,0,1
"Lee Min-Hui",28,"South Korea",2008,Handball,0,0,1,1
"Demetrio Lozano",32,Spain,2008,Handball,0,0,1,1
"Kristine Lunde-Borgersen",28,Norway,2008,Handball,1,0,0,1
"Cristian Malmagro",25,Spain,2008,Handball,0,0,1,1
"Yekaterina Marennikova",26,Russia,2008,Handball,0,1,0,1
"Mun Pil-Hui",25,"South Korea",2008,Handball,0,0,1,1
"Daniel Narcisse",28,France,2008,Handball,1,0,0,1
"Katja Nyberg",28,Norway,2008,Handball,1,0,0,1
"Tonje Nøstvold",23,Norway,2008,Handball,1,0,0,1
"Oh Seong-Ok",35,"South Korea",2008,Handball,0,0,1,1
"Oh Yeong-Ran",35,"South Korea",2008,Handball,0,0,1,1
"Thierry Omeyer",31,France,2008,Handball,1,0,0,1
"Park Jeong-Hui",33,"South Korea",2008,Handball,0,0,1,1
"Cédric Paty",27,France,2008,Handball,1,0,0,1
"Alexander Petersson",28,Iceland,2008,Handball,0,1,0,1
"Irina Poltoratskaya",29,Russia,2008,Handball,0,1,0,1
"Yelena Polyonova",24,Russia,2008,Handball,0,1,0,1
"Lyudmila Postnova",23,Russia,2008,Handball,0,1,0,1
"Carlos Prieto",28,Spain,2008,Handball,0,0,1,1
"Linn-Kristin Riegelhuth Koren",24,Norway,2008,Handball,1,0,0,1
"Albert Rocas",26,Spain,2008,Handball,0,0,1,1
"Oksana Romenskaya",32,Russia,2008,Handball,0,1,0,1
"Iker Romero",28,Spain,2008,Handball,0,0,1,1
"Nataliya Shipilova",28,Russia,2008,Handball,0,1,0,1
"Mariya Sidorova",28,Russia,2008,Handball,0,1,0,1
"Guðjón Valur Sigurðsson",29,Iceland,2008,Handball,0,1,0,1
"Sigfús Sigurðsson",33,Iceland,2008,Handball,0,1,0,1
"Gøril Snorroeggen",23,Norway,2008,Handball,1,0,0,1
"Song Hai-Rim",23,"South Korea",2008,Handball,0,0,1,1
"Ólafur Stefánsson",35,Iceland,2008,Handball,0,1,0,1
"Inna Suslina",29,Russia,2008,Handball,0,1,0,1
"Else-Marthe Sørlie Lybekk",29,Norway,2008,Handball,1,0,0,1
"Víctor Tomás",23,Spain,2008,Handball,0,0,1,1
"Emiliya Turey",23,Russia,2008,Handball,0,1,0,1
"Yana Uskova",22,Russia,2008,Handball,0,1,0,1
"Andreea Acatrinei",16,Romania,2008,Gymnastics,0,0,1,1
"Sasha Artemev",22,"United States",2008,Gymnastics,0,0,1,1
"Raj Bhavsar",27,"United States",2008,Gymnastics,0,0,1,1
"Leszek Blanik",31,Poland,2008,Gymnastics,1,0,0,1
"Thomas Bouhail",22,France,2008,Gymnastics,0,1,0,1
"Benoît Caranobe",28,France,2008,Gymnastics,0,0,1,1
"Oksana Chusovitina",33,Germany,2008,Gymnastics,0,1,0,1
"Gervasio Deferr",27,Spain,2008,Gymnastics,0,1,0,1
"Deng Linlin",16,China,2008,Gymnastics,1,0,0,1
"Gabriela Dragoi",15,Romania,2008,Gymnastics,0,0,1,1
"Anton Fokin",25,Uzbekistan,2008,Gymnastics,0,0,1,1
"Andreea Grigore",17,Romania,2008,Gymnastics,0,0,1,1
"Joey Hagerty",26,"United States",2008,Gymnastics,0,0,1,1
"Fabian Hambüchen",20,Germany,2008,Gymnastics,0,0,1,1
"Hong Un-Jong",19,"North Korea",2008,Gymnastics,1,0,0,1
"Huang Xu",29,China,2008,Gymnastics,1,0,0,1
"Jiang Yuyuan",16,China,2008,Gymnastics,1,0,0,1
"Takehiro Kashima",28,Japan,2008,Gymnastics,0,1,0,1
"Li Shanshan",16,China,2008,Gymnastics,1,0,0,1
"Chellsie Memmel",20,"United States",2008,Gymnastics,0,1,0,1
"Takuya Nakase",25,Japan,2008,Gymnastics,0,1,0,1
"Steliana Nistor",18,Romania,2008,Gymnastics,0,0,1,1
"Makoto Okiguchi",22,Japan,2008,Gymnastics,0,1,0,1
"Samantha Peszek",16,"United States",2008,Gymnastics,0,1,0,1
"Alicia Sacramone",20,"United States",2008,Gymnastics,0,1,0,1
"Koki Sakamoto",21,Japan,2008,Gymnastics,0,1,0,1
"Bridget Sloan",16,"United States",2008,Gymnastics,0,1,0,1
"Louis Smith",19,"Great Britain",2008,Gymnastics,0,0,1,1
"Justin Spring",24,"United States",2008,Gymnastics,0,0,1,1
"Ana Tamârjan",17,Romania,2008,Gymnastics,0,0,1,1
"Kevin Tan",26,"United States",2008,Gymnastics,0,0,1,1
"Hiroyuki Tomita",27,Japan,2008,Gymnastics,0,1,0,1
"Filip Ude",22,Croatia,2008,Gymnastics,0,1,0,1
"Oleksandr Vorobiov",23,Ukraine,2008,Gymnastics,0,0,1,1
"Yu Won-Cheol",24,"South Korea",2008,Gymnastics,0,1,0,1
"Lautaro Acosta",20,Argentina,2008,Football,1,0,0,1
"Olubayo Adefemi",22,Nigeria,2008,Football,0,1,0,1
"Dele Adeleye",19,Nigeria,2008,Football,0,1,0,1
"Sergio Agüero",20,Argentina,2008,Football,1,0,0,1
"Femi Ajilore",23,Nigeria,2008,Football,0,1,0,1
"Alexandre Pato",18,Brazil,2008,Football,0,0,1,1
"Efe Ambrose",19,Nigeria,2008,Football,0,1,0,1
Ânderson,20,Brazil,2008,Football,0,0,1,1
Andréia,30,Brazil,2008,Football,0,1,0,1
"Nadine Angerer",29,Germany,2008,Football,0,0,1,1
"Victor Anichebe",20,Nigeria,2008,Football,0,1,0,1
"Onyekachi Apam",21,Nigeria,2008,Football,0,1,0,1
"Lira Bajramaj",20,Germany,2008,Football,0,0,1,1
"Éver Banega",20,Argentina,2008,Football,1,0,0,1
Bárbara,20,Brazil,2008,Football,0,1,0,1
"Melanie Behringer",22,Germany,2008,Football,0,0,1,1
"Shannon Boxx",31,"United States",2008,Football,1,0,0,1
Breno,18,Brazil,2008,Football,0,0,1,1
"Linda Bresonik",24,Germany,2008,Football,0,0,1,1
"Rachel Buehler",22,"United States",2008,Football,1,0,0,1
"Diego Buonanotte",20,Argentina,2008,Football,1,0,0,1
"Lori Chalupny",24,"United States",2008,Football,1,0,0,1
"Lauren Cheney",20,"United States",2008,Football,1,0,0,1
"Stephanie Cox",22,"United States",2008,Football,1,0,0,1
Cristiane,23,Brazil,2008,Football,0,1,0,1
Daniela,24,Brazil,2008,Football,0,1,0,1
"Ángel Di María",20,Argentina,2008,Football,1,0,0,1
Diego,23,Brazil,2008,Football,0,0,1,1
"Emmanuel Ekpo",20,Nigeria,2008,Football,0,1,0,1
Érika,20,Brazil,2008,Football,0,1,0,1
Ester,25,Brazil,2008,Football,0,1,0,1
Fabiana,19,Brazil,2008,Football,0,1,0,1
"Federico Fazio",21,Argentina,2008,Football,1,0,0,1
Formiga,30,Brazil,2008,Football,0,1,0,1
Francielle,18,Brazil,2008,Football,0,1,0,1
"Fernando Gago",22,Argentina,2008,Football,1,0,0,1
"Ezequiel Garay",21,Argentina,2008,Football,1,0,0,1
"Kerstin Garefrekes",28,Germany,2008,Football,0,0,1,1
"Tobin Heath",20,"United States",2008,Football,1,0,0,1
Hernanes,23,Brazil,2008,Football,0,0,1,1
"Ariane Hingst",29,Germany,2008,Football,0,0,1,1
"Angela Hucles",30,"United States",2008,Football,1,0,0,1
Ilsinho,22,Brazil,2008,Football,0,0,1,1
"Promise Isaac",20,Nigeria,2008,Football,0,1,0,1
"Monday James",21,Nigeria,2008,Football,0,1,0,1
Jô,21,Brazil,2008,Football,0,0,1,1
"Tasha Kai",25,"United States",2008,Football,1,0,0,1
"Sani Kaita",22,Nigeria,2008,Football,0,1,0,1
Kóki,22,Brazil,2008,Football,0,1,0,1
"Annike Krahn",23,Germany,2008,Football,0,0,1,1
"Simone Laudehr",22,Germany,2008,Football,0,0,1,1
"Ezequiel Lavezzi",23,Argentina,2008,Football,1,0,0,1
"Renate Lingor",32,Germany,2008,Football,0,0,1,1
"Carli Lloyd",26,"United States",2008,Football,1,0,0,1
Lucas,21,Brazil,2008,Football,0,0,1,1
Marcelo,20,Brazil,2008,Football,0,0,1,1
Marta,22,Brazil,2008,Football,0,1,0,1
"Javier Mascherano",24,Argentina,2008,Football,1,0,0,1
Maurine,22,Brazil,2008,Football,0,1,0,1
Maycon,31,Brazil,2008,Football,0,1,0,1
"Lionel Messi",21,Argentina,2008,Football,1,0,0,1
"Anja Mittag",23,Germany,2008,Football,0,0,1,1
"Heather Mitts",30,"United States",2008,Football,1,0,0,1
"Fabián Monzón",21,Argentina,2008,Football,1,0,0,1
"Thiago Neves",23,Brazil,2008,Football,0,0,1,1
"Heather O'Reilly",23,"United States",2008,Football,1,0,0,1
"Victor Obinna",21,Nigeria,2008,Football,0,1,0,1
"Peter Odemwingie",27,Nigeria,2008,Football,0,1,0,1
"Chinedu Ogbuke",22,Nigeria,2008,Football,0,1,0,1
"Chibuzor Okonkwo",19,Nigeria,2008,Football,0,1,0,1
"Solomon Okoronkwo",21,Nigeria,2008,Football,0,1,0,1
"Célia Okoyino da Mbabi",20,Germany,2008,Football,0,0,1,1
"Nicolás Pareja",24,Argentina,2008,Football,1,0,0,1
"Christie Pearce-Rampone",33,"United States",2008,Football,1,0,0,1
"Babett Peter",20,Germany,2008,Football,0,0,1,1
"Conny Pohlers",29,Germany,2008,Football,0,0,1,1
Pretinha,33,Brazil,2008,Football,0,1,0,1
"Birgit Prinz",30,Germany,2008,Football,0,0,1,1
Rafinha,22,Brazil,2008,Football,0,0,1,1
Ramires,21,Brazil,2008,Football,0,0,1,1
Renan,23,Brazil,2008,Football,0,0,1,1
"Juan Riquelme",30,Argentina,2008,Football,1,0,0,1
"Amy Rodriguez",21,"United States",2008,Football,1,0,0,1
"Sergio Romero",21,Argentina,2008,Football,1,0,0,1
Ronaldinho,28,Brazil,2008,Football,0,0,1,1
"Andréia Rosa",24,Brazil,2008,Football,0,1,0,1
Rosana,26,Brazil,2008,Football,0,1,0,1
"Alex Silva",23,Brazil,2008,Football,0,0,1,1
"Thiago Silva",23,Brazil,2008,Football,0,0,1,1
Simone,27,Brazil,2008,Football,0,1,0,1
"Sandra Smisek",31,Germany,2008,Football,0,0,1,1
"Rafael Sóbis",23,Brazil,2008,Football,0,0,1,1
"Kate Sobrero-Markgraf",31,"United States",2008,Football,1,0,0,1
"Hope Solo",27,"United States",2008,Football,1,0,0,1
"José Sosa",23,Argentina,2008,Football,1,0,0,1
"Kerstin Stegemann",30,Germany,2008,Football,0,0,1,1
"Tânia Maranhão",33,Brazil,2008,Football,0,1,0,1
"Lindsay Tarpley",24,"United States",2008,Football,1,0,0,1
"Óscar Ustari",22,Argentina,2008,Football,1,0,0,1
"Ambruse Vanzekin",22,Nigeria,2008,Football,0,1,0,1
"Aly Wagner",27,"United States",2008,Football,1,0,0,1
"Pablo Zabaleta",23,Argentina,2008,Football,1,0,0,1
"José Luis Abajo",30,Spain,2008,Fencing,0,0,1,1
"Robert Andrzejuk",33,Poland,2008,Fencing,0,1,0,1
"Bao Yingying",24,China,2008,Fencing,0,1,0,1
"Svetlana Boyko",36,Russia,2008,Fencing,1,0,0,1
"Ana Brânza",23,Romania,2008,Fencing,0,1,0,1
"Diego Confalonieri",29,Italy,2008,Fencing,0,0,1,1
"Mihai Covaliu",30,Romania,2008,Fencing,0,0,1,1
"Emily Cross",21,"United States",2008,Fencing,0,1,0,1
"Britta Heidemann",25,Germany,2008,Fencing,1,0,0,1
"Huang Haiyang",22,China,2008,Fencing,0,1,0,1
"Jérôme Jeannet",31,France,2008,Fencing,1,0,0,1
"Olha Kharlan",17,Ukraine,2008,Fencing,1,0,0,1
"Olena Khomrova",21,Ukraine,2008,Fencing,1,0,0,1
"Benjamin Kleibrink",23,Germany,2008,Fencing,1,0,0,1
"Yevgeniya Lamonova",25,Russia,2008,Fencing,1,0,0,1
"Aldo Montano",29,Italy,2008,Fencing,0,0,1,1
"Tim Morehouse",30,"United States",2008,Fencing,0,1,0,1
"Tomasz Motyka",27,Poland,2008,Fencing,0,1,0,1
"Nam Hyeon-Hui",26,"South Korea",2008,Fencing,0,1,0,1
"Ildikó Nébaldné Mincza",38,Hungary,2008,Fencing,0,0,1,1
"Ni Hong",22,China,2008,Fencing,0,1,0,1
"Viktoriya Nikishina",23,Russia,2008,Fencing,1,0,0,1
"Diego Occhiuzzi",27,Italy,2008,Fencing,0,0,1,1
"Yuki Ota",22,Japan,2008,Fencing,0,1,0,1
"Gianpiero Pastore",32,Italy,2008,Fencing,0,0,1,1
"Julien Pillet",30,France,2008,Fencing,1,0,0,1
"Halyna Pundyk",20,Ukraine,2008,Fencing,1,0,0,1
"Ulrich Robeiri",25,France,2008,Fencing,1,0,0,1
"Jason Rogers",25,"United States",2008,Fencing,0,1,0,1
"Alfredo Rota",33,Italy,2008,Fencing,0,0,1,1
"Ilaria Salvatori",29,Italy,2008,Fencing,0,0,1,1
"Boris Sanson",27,France,2008,Fencing,1,0,0,1
"Salvatore Sanzo",32,Italy,2008,Fencing,0,0,1,1
"Aida Shanayeva",22,Russia,2008,Fencing,1,0,0,1
"Erinn Smart",28,"United States",2008,Fencing,0,1,0,1
"Keeth Smart",30,"United States",2008,Fencing,0,1,0,1
"Tan Xue",24,China,2008,Fencing,0,1,0,1
"Luigi Tarantino",35,Italy,2008,Fencing,0,0,1,1
"Hanna Thompson",24,"United States",2008,Fencing,0,1,0,1
"Giovanna Trillini",38,Italy,2008,Fencing,0,0,1,1
"Adam Wiercioch",27,Poland,2008,Fencing,0,1,0,1
"James Williams",22,"United States",2008,Fencing,0,1,0,1
"Radoslaw Zawrotniak",26,Poland,2008,Fencing,0,1,0,1
"Zhong Man",25,China,2008,Fencing,1,0,0,1
"Olha Zhovnir",19,Ukraine,2008,Fencing,1,0,0,1
"Rolf-Göran Bengtsson",46,Sweden,2008,Equestrian,0,1,0,1
"Nadine Capellmann",43,Germany,2008,Equestrian,1,0,0,1
"Mac Cone",55,Canada,2008,Equestrian,0,1,0,1
"Andreas Dibowski",42,Germany,2008,Equestrian,1,0,0,1
"Daisy Dick",36,"Great Britain",2008,Equestrian,0,0,1,1
"William Fox-Pitt",39,"Great Britain",2008,Equestrian,0,0,1,1
"Clayton Fredericks",40,Australia,2008,Equestrian,0,1,0,1
"Lucinda Fredericks",42,Australia,2008,Equestrian,0,1,0,1
"Steve Guerdat",26,Switzerland,2008,Equestrian,0,0,1,1
"Andreas Helgstrand",30,Denmark,2008,Equestrian,0,0,1,1
"Jill Henselwood",45,Canada,2008,Equestrian,0,1,0,1
"Sharon Hunt",30,"Great Britain",2008,Equestrian,0,0,1,1
"Anne Jensen-van Olst",46,Denmark,2008,Equestrian,0,0,1,1
"Sonja Johnson",40,Australia,2008,Equestrian,0,1,0,1
"Megan Jones",31,Australia,2008,Equestrian,0,1,0,1
"Ingrid Klimke",40,Germany,2008,Equestrian,1,0,0,1
"Laura Kraut",42,"United States",2008,Equestrian,1,0,0,1
"Christina Liebherr",29,Switzerland,2008,Equestrian,0,0,1,1
"Gina Miles",34,"United States",2008,Equestrian,0,1,0,1
"Ian Millar",61,Canada,2008,Equestrian,0,1,0,1
"Hans Peter Minderhoud",34,Netherlands,2008,Equestrian,0,1,0,1
"Frank Ostholt",32,Germany,2008,Equestrian,1,0,0,1
"Shane Rose",35,Australia,2008,Equestrian,0,1,0,1
"Imke Schellekens-Bartels",31,Netherlands,2008,Equestrian,0,1,0,1
"Niklaus Schurtenberger",40,Switzerland,2008,Equestrian,0,0,1,1
"Pius Schwizer",46,Switzerland,2008,Equestrian,0,0,1,1
"Will Simpson",49,"United States",2008,Equestrian,1,0,0,1
"Peter Thomsen",47,Germany,2008,Equestrian,1,0,0,1
"Mary Thomson-King",47,"Great Britain",2008,Equestrian,0,0,1,1
"McLain Ward",32,"United States",2008,Equestrian,1,0,0,1
"Nathalie zu Sayn-Wittgenstein",33,Denmark,2008,Equestrian,0,0,1,1
"Bree Cole",25,Australia,2008,Diving,0,1,0,1
"Alexandre Despatie",23,Canada,2008,Diving,0,1,0,1
"Dmitry Dobroskok",24,Russia,2008,Diving,0,0,1,1
"Paola Espinosa",22,Mexico,2008,Diving,0,0,1,1
"Heike Fischer",25,Germany,2008,Diving,0,0,1,1
"Patrick Hausding",19,Germany,2008,Diving,0,1,0,1
"He Chong",21,China,2008,Diving,1,0,0,1
"Emilie Heymans",26,Canada,2008,Diving,0,1,0,1
"Huo Liang",18,China,2008,Diving,1,0,0,1
"Sascha Klein",22,Germany,2008,Diving,0,1,0,1
"Ditte Kotzian",29,Germany,2008,Diving,0,0,1,1
"Yury Kunakov",18,Russia,2008,Diving,0,1,0,1
"Illia Kvasha",20,Ukraine,2008,Diving,0,0,1,1
"Lin Yue",17,China,2008,Diving,1,0,0,1
"Matt Mitcham",20,Australia,2008,Diving,1,0,0,1
"Tatiana Ortíz",24,Mexico,2008,Diving,0,0,1,1
"Anastasia Pozdnyakova",22,Russia,2008,Diving,0,1,0,1
"Oleksiy Pryhorov",21,Ukraine,2008,Diving,0,0,1,1
"Dmitry Sautin",34,Russia,2008,Diving,0,1,0,1
"Wang Feng",29,China,2008,Diving,1,0,0,1
"Melissa Wu",16,Australia,2008,Diving,0,1,0,1
"Zhou Luxin",20,China,2008,Diving,0,1,0,1
"Julien Absalon",28,France,2008,Cycling,1,0,0,1
"Kristin Armstrong",35,"United States",2008,Cycling,1,0,0,1
"Grégory Baugé",23,France,2008,Cycling,0,1,0,1
"Sam Bewley",21,"New Zealand",2008,Cycling,0,0,1,1
"Steven Burke",20,"Great Britain",2008,Cycling,0,0,1,1
"Anne-Caroline Chausson",30,France,2008,Cycling,1,0,0,1
"Michael Færk Christensen",22,Denmark,2008,Cycling,0,1,0,1
"Ed Clancy",23,"Great Britain",2008,Cycling,1,0,0,1
"Nicole Cooke",25,"Great Britain",2008,Cycling,1,0,0,1
"Juan Esteban Curuchet",43,Argentina,2008,Cycling,1,0,0,1
"Mike Day",23,"United States",2008,Cycling,0,1,0,1
"Ross Edgar",25,"Great Britain",2008,Cycling,0,1,0,1
"René Enders",21,Germany,2008,Cycling,0,0,1,1
"Yoanka González",32,Cuba,2008,Cycling,0,1,0,1
"Westley Gough",20,"New Zealand",2008,Cycling,0,0,1,1
"Tania Guderzo",23,Italy,2008,Cycling,0,0,1,1
"Guo Shuang",22,China,2008,Cycling,0,0,1,1
"Wendy Houvenaghel",33,"Great Britain",2008,Cycling,0,1,0,1
"Mikhail Ignatyev",23,Russia,2008,Cycling,0,0,1,1
"Emma Johansson",24,Sweden,2008,Cycling,0,1,0,1
"Casper Jørgensen",22,Denmark,2008,Cycling,0,1,0,1
"Irina Kalentyeva",30,Russia,2008,Cycling,0,0,1,1
"Lesia Kalytovska",20,Ukraine,2008,Cycling,0,0,1,1
"Jill Kintner",26,"United States",2008,Cycling,0,0,1,1
"Roger Kluge",22,Germany,2008,Cycling,0,1,0,1
"Aleksandr Kolobnev",27,Russia,2008,Cycling,0,0,1,1
"Gustav Larsson",27,Sweden,2008,Cycling,0,1,0,1
"Laëtitia Le Corguillé",22,France,2008,Cycling,0,1,0,1
"Levi Leipheimer",34,"United States",2008,Cycling,0,0,1,1
"Maximilian Levy",21,Germany,2008,Cycling,0,0,1,1
"Jens-Erik Madsen",27,Denmark,2008,Cycling,0,1,0,1
"Paul Manning",33,"Great Britain",2008,Cycling,1,0,0,1
"Aleksey Markov",29,Russia,2008,Cycling,0,0,1,1
"Anna Meares",24,Australia,2008,Cycling,0,1,0,1
"Michael Mørkøv",23,Denmark,2008,Cycling,0,1,0,1
"Kiyofumi Nagai",25,Japan,2008,Cycling,0,0,1,1
"Chris Newton",34,"Great Britain",2008,Cycling,0,0,1,1
"Stefan Nimke",30,Germany,2008,Cycling,0,0,1,1
"Leire Olaberria",31,Spain,2008,Cycling,0,0,1,1
"Vicki Pendleton",27,"Great Britain",2008,Cycling,1,0,0,1
"Jean-Christophe Péraud",31,France,2008,Cycling,0,1,0,1
"Walter Pérez",35,Argentina,2008,Cycling,1,0,0,1
"Emma Pooley",25,"Great Britain",2008,Cycling,0,1,0,1
"Alex Rasmussen",24,Denmark,2008,Cycling,0,1,0,1
"Donny Robinson",25,"United States",2008,Cycling,0,0,1,1
"Rebecca Romero",28,"Great Britain",2008,Cycling,1,0,0,1
"Marc Ryan",25,"New Zealand",2008,Cycling,0,0,1,1
"Samuel Sánchez",30,Spain,2008,Cycling,1,0,0,1
"Nino Schurter",22,Switzerland,2008,Cycling,0,0,1,1
"Jesse Sergent",20,"New Zealand",2008,Cycling,0,0,1,1
"Kévin Sireau",21,France,2008,Cycling,0,1,0,1
"Sabine Spitz",36,Germany,2008,Cycling,1,0,0,1
"Jamie Staff",35,"Great Britain",2008,Cycling,1,0,0,1
"Maris Štrombergs",21,Latvia,2008,Cycling,1,0,0,1
"Toni Tauler",34,Spain,2008,Cycling,0,1,0,1
"Geraint Thomas",22,"Great Britain",2008,Cycling,1,0,0,1
"Karin Thürig",36,Switzerland,2008,Cycling,0,0,1,1
"Arnaud Tournant",30,France,2008,Cycling,0,1,0,1
"Marianne Vos",21,Netherlands,2008,Cycling,1,0,0,1
"Maja Wloszczowska",24,Poland,2008,Cycling,0,1,0,1
"Aleksey Abalmasov",28,Belarus,2008,Canoeing,1,0,0,1
"Lutz Altepost",26,Germany,2008,Canoeing,0,0,1,1
"Rob Bell",30,Australia,2008,Canoeing,0,0,1,1
"Aleksandr Bogdanovich",26,Belarus,2008,Canoeing,1,0,0,1
"Andrey Bogdanovich",20,Belarus,2008,Canoeing,1,0,0,1
"Benjamin Boukpeti",27,Togo,2008,Canoeing,0,0,1,1
"Norman Bröckl",21,Germany,2008,Canoeing,0,0,1,1
"Yuriy Cheban",22,Ukraine,2008,Canoeing,0,0,1,1
"Saúl Craviotto",23,Spain,2008,Canoeing,1,0,0,1
"Hannah Davis",23,Australia,2008,Canoeing,0,0,1,1
"Marie Delattre",27,France,2008,Canoeing,0,0,1,1
"Torsten Eckbrett",24,Germany,2008,Canoeing,0,0,1,1
"Andrea Facchin",29,Italy,2008,Canoeing,0,0,1,1
"Fanny Fischer",21,Germany,2008,Canoeing,1,0,0,1
"David Florence",26,"Great Britain",2008,Canoeing,0,1,0,1
"Lyndsie Fogarty",24,Australia,2008,Canoeing,0,0,1,1
"Björn Goldschmidt",28,Germany,2008,Canoeing,0,0,1,1
"Alexander Grimm",21,Germany,2008,Canoeing,1,0,0,1
"Thomas Hall",26,Canada,2008,Canoeing,0,0,1,1
"Pavol Hochschorner",28,Slovakia,2008,Canoeing,1,0,0,1
"Peter Hochschorner",28,Slovakia,2008,Canoeing,1,0,0,1
"Martin Hollstein",21,Germany,2008,Canoeing,1,0,0,1
"Josefa Idem-Guerrini",43,Italy,2008,Canoeing,0,1,0,1
"Andreas Ihle",29,Germany,2008,Canoeing,1,0,0,1
"Elena Kaliská",36,Slovakia,2008,Canoeing,1,0,0,1
"Tamás Kiss",21,Hungary,2008,Canoeing,0,0,1,1
"Kim Knudsen",30,Denmark,2008,Canoeing,0,1,0,1
"Aleksandr Kostoglod",34,Russia,2008,Canoeing,0,1,0,1
"Danuta Kozák",21,Hungary,2008,Canoeing,0,1,0,1
"György Kozmann",30,Hungary,2008,Canoeing,0,0,1,1
"Mikhail Kuznetsov",23,Russia,2008,Canoeing,0,0,1,1
"Dmitry Larionov",22,Russia,2008,Canoeing,0,0,1,1
"Eirik Verås Larsen",32,Norway,2008,Canoeing,0,1,0,1
"Jacqui Lawrence",26,Australia,2008,Canoeing,0,1,0,1
"Fabien Lefèvre",26,France,2008,Canoeing,0,1,0,1
"Artur Litvinchuk",20,Belarus,2008,Canoeing,1,0,0,1
"Michal Martikán",29,Slovakia,2008,Canoeing,1,0,0,1
"Chantal Meek",29,Australia,2008,Canoeing,0,0,1,1
"Meng Guanliang",31,China,2008,Canoeing,1,0,0,1
"Beata Mikolajczyk",22,Poland,2008,Canoeing,0,1,0,1
"Violetta Oblinger-Peters",30,Austria,2008,Canoeing,0,0,1,1
"Lisa Oldenhof",28,Australia,2008,Canoeing,0,0,1,1
"Maksim Opalev",29,Russia,2008,Canoeing,1,0,0,1
"Inna Osypenko-Radomska",25,Ukraine,2008,Canoeing,1,0,0,1
"Aneta Pastuszka-Konieczna",30,Poland,2008,Canoeing,0,1,0,1
"Carlos Pérez",29,Spain,2008,Canoeing,1,0,0,1
"René Poulsen",19,Denmark,2008,Canoeing,0,1,0,1
"Ronald Rauhe",26,Germany,2008,Canoeing,0,1,0,1
"Nicole Reinhardt",22,Germany,2008,Canoeing,1,0,0,1
"Michal Riszdorfer",31,Slovakia,2008,Canoeing,0,1,0,1
"Richard Riszdorfer",27,Slovakia,2008,Canoeing,0,1,0,1
"Antonio Scaduto",30,Italy,2008,Canoeing,0,0,1,1
"Ondrej Štepánek",28,"Czech Republic",2008,Canoeing,0,1,0,1
"Gabriella Szabó",22,Hungary,2008,Canoeing,0,1,0,1
"Juraj Tarr",29,Slovakia,2008,Canoeing,0,1,0,1
"Sergey Ulegin",30,Russia,2008,Canoeing,0,1,0,1
"Attila Vajda",25,Hungary,2008,Canoeing,1,0,0,1
"Adam Van Koeverden",26,Canada,2008,Canoeing,0,1,0,1
"Anne-Laure Viard",27,France,2008,Canoeing,0,0,1,1
"Erik Vlcek",26,Slovakia,2008,Canoeing,0,1,0,1
"Jaroslav Volf",28,"Czech Republic",2008,Canoeing,0,1,0,1
"Conny Wassmuth",25,Germany,2008,Canoeing,1,0,0,1
"Tim Wieskötter",29,Germany,2008,Canoeing,0,1,0,1
"Yang Wenjun",24,China,2008,Canoeing,1,0,0,1
"Brett Anderson",20,"United States",2008,Baseball,0,0,1,1
"Jake Arrieta",22,"United States",2008,Baseball,0,0,1,1
"Brian Barden",27,"United States",2008,Baseball,0,0,1,1
"Alexei Bell",24,Cuba,2008,Baseball,0,1,0,1
"Bong Jung-Keun",28,"South Korea",2008,Baseball,1,0,0,1
"Matt Brown",26,"United States",2008,Baseball,0,0,1,1
"Trevor Cahill",20,"United States",2008,Baseball,0,0,1,1
"Frederich Cepeda",28,Cuba,2008,Baseball,0,1,0,1
"Jeremy Cummings",31,"United States",2008,Baseball,0,0,1,1
"Alfredo Despaigne",22,Cuba,2008,Baseball,0,1,0,1
"Jason Donald",23,"United States",2008,Baseball,0,0,1,1
"Brian Duensing",25,"United States",2008,Baseball,0,0,1,1
"Giorvis Duvergel",28,Cuba,2008,Baseball,0,1,0,1
"Michel Enríquez",29,Cuba,2008,Baseball,0,1,0,1
"Dexter Fowler",22,"United States",2008,Baseball,0,0,1,1
"John Gall",30,"United States",2008,Baseball,0,0,1,1
"Gang Min-Ho",22,"South Korea",2008,Baseball,1,0,0,1
"Go Yeong-Min",24,"South Korea",2008,Baseball,1,0,0,1
"Norberto González",28,Cuba,2008,Baseball,0,1,0,1
"Yulieski Gourriel",24,Cuba,2008,Baseball,0,1,0,1
"Gwon Hyeok",24,"South Korea",2008,Baseball,1,0,0,1
"Han Gi-Ju",21,"South Korea",2008,Baseball,1,0,0,1
"Mike Hessman",30,"United States",2008,Baseball,0,0,1,1
"Jang Won-Sam",25,"South Korea",2008,Baseball,1,0,0,1
"Jeong Dae-Hyeon",29,"South Korea",2008,Baseball,1,0,0,1
"Jeong Geun-U",25,"South Korea",2008,Baseball,1,0,0,1
"Kevin Jepsen",24,"United States",2008,Baseball,0,0,1,1
"Jin Gab-Yong",34,"South Korea",2008,Baseball,1,0,0,1
"Kim Dong-Ju",32,"South Korea",2008,Baseball,1,0,0,1
"Kim Gwang-Hyeon",20,"South Korea",2008,Baseball,1,0,0,1
"Kim Hyeon-Su",20,"South Korea",2008,Baseball,1,0,0,1
"Kim Min-Jae",35,"South Korea",2008,Baseball,1,0,0,1
"Brandon Knight",32,"United States",2008,Baseball,0,0,1,1
"Mike Koplove",31,"United States",2008,Baseball,0,0,1,1
"Miguel La Hera",23,Cuba,2008,Baseball,0,1,0,1
"Matt LaPorta",23,"United States",2008,Baseball,0,0,1,1
"Pedro Luis Lazo",35,Cuba,2008,Baseball,0,1,0,1
"Lee Dae-Ho",26,"South Korea",2008,Baseball,1,0,0,1
"Lee Jin-Yeong",28,"South Korea",2008,Baseball,1,0,0,1
"Lee Jong-Uk",28,"South Korea",2008,Baseball,1,0,0,1
"Lee Seung-Yeop",31,"South Korea",2008,Baseball,1,0,0,1
"Lee Taek-Geun",28,"South Korea",2008,Baseball,1,0,0,1
"Lee Yong-Gyu",22,"South Korea",2008,Baseball,1,0,0,1
"Lou Marson",22,"United States",2008,Baseball,0,0,1,1
"Jonder Martínez",30,Cuba,2008,Baseball,0,1,0,1
"Alexander Mayeta",31,Cuba,2008,Baseball,0,1,0,1
"Rolando Meriño",37,Cuba,2008,Baseball,0,1,0,1
"Luis Miguel Navas",28,Cuba,2008,Baseball,0,1,0,1
"Blaine Neal",30,"United States",2008,Baseball,0,0,1,1
"Jayson Nix",25,"United States",2008,Baseball,0,0,1,1
"O Seung-Hwan",26,"South Korea",2008,Baseball,1,0,0,1
"Vicyohandri Odelín",28,Cuba,2008,Baseball,0,1,0,1
"Héctor Olivera Jr.",23,Cuba,2008,Baseball,0,1,0,1
"Adiel Palma",37,Cuba,2008,Baseball,0,1,0,1
"Eduardo Paret",35,Cuba,2008,Baseball,0,1,0,1
"Park Jin-Man",31,"South Korea",2008,Baseball,1,0,0,1
"Yadier Pedroso",22,Cuba,2008,Baseball,0,1,0,1
"Ariel Pestano",34,Cuba,2008,Baseball,0,1,0,1
"Luis Miguel Rodríguez",35,Cuba,2008,Baseball,0,1,0,1
"Ryu Hyeon-Jin",21,"South Korea",2008,Baseball,1,0,0,1
"Elier Sánchez",21,Cuba,2008,Baseball,0,1,0,1
"Eriel Sánchez",33,Cuba,2008,Baseball,0,1,0,1
"Nate Schierholtz",24,"United States",2008,Baseball,0,0,1,1
"Song Seung-Jun",28,"South Korea",2008,Baseball,1,0,0,1
"Jeff Stevens",24,"United States",2008,Baseball,0,0,1,1
"Stephen Strasburg",20,"United States",2008,Baseball,0,0,1,1
"Taylor Teagarden",24,"United States",2008,Baseball,0,0,1,1
"Terry Tiffee",29,"United States",2008,Baseball,0,0,1,1
"Yoandri Urgellés",27,Cuba,2008,Baseball,0,1,0,1
"Norge Luis Vera",37,Cuba,2008,Baseball,0,1,0,1
"Casey Weathers",23,"United States",2008,Baseball,0,0,1,1
"Yoon Suk-Min",22,"South Korea",2008,Baseball,1,0,0,1
"Osmay Acosta",23,Cuba,2008,Boxing,0,0,1,1
"Georgiy Balakshin",28,Russia,2008,Boxing,0,0,1,1
"Carlos Banteux",21,Cuba,2008,Boxing,0,1,0,1
"Paddy Barnes",21,Ireland,2008,Boxing,0,0,1,1
"Manus Boonjumnong",28,Thailand,2008,Boxing,0,1,0,1
"Roberto Cammarelle",28,Italy,2008,Boxing,1,0,0,1
"Rakhim Chakhkiyev",25,Russia,2008,Boxing,1,0,0,1
"Emilio Correa Jr.",22,Cuba,2008,Boxing,0,1,0,1
"James DeGale",22,"Great Britain",2008,Boxing,1,0,0,1
"Félix Díaz",24,"Dominican Republic",2008,Boxing,1,0,0,1
"Khédafi Djelkhir",24,France,2008,Boxing,0,1,0,1
"Kenny Egan",26,Ireland,2008,Boxing,0,1,0,1
"Enkhbatyn Badar-Uugan",23,Mongolia,2008,Boxing,1,0,0,1
"Vaeceslav Gojan",25,Moldova,2008,Boxing,0,0,1,1
"Hanati Silamu",23,China,2008,Boxing,0,0,1,1
"Yampier Hernández",23,Cuba,2008,Boxing,0,0,1,1
"V'iacheslav Hlazkov",23,Ukraine,2008,Boxing,0,0,1,1
"Roniel Iglesias",19,Cuba,2008,Boxing,0,0,1,1
"Sahin Imranov",27,Azerbaijan,2008,Boxing,0,0,1,1
"Hrachik Javakhyan",24,Armenia,2008,Boxing,0,0,1,1
"Tony Jeffries",23,"Great Britain",2008,Boxing,0,0,1,1
"Somjit Jongjohor",33,Thailand,2008,Boxing,1,0,0,1
"Bruno Julie",30,Mauritius,2008,Boxing,0,0,1,1
"Yakup Kiliç",22,Turkey,2008,Boxing,0,0,1,1
"Kim Jeong-Ju",26,"South Korea",2008,Boxing,0,0,1,1
"Andry Laffita",30,Cuba,2008,Boxing,0,1,0,1
"Yankiel León",26,Cuba,2008,Boxing,0,1,0,1
"Vasyl Lomachenko",20,Ukraine,2008,Boxing,1,0,0,1
"Vincenzo Picardi",24,Italy,2008,Boxing,0,0,1,1
"David Price",25,"Great Britain",2008,Boxing,0,0,1,1
"Pürevdorjin Serdamba",23,Mongolia,2008,Boxing,0,1,0,1
"Clemente Russo",26,Italy,2008,Boxing,0,1,0,1
"Bakhyt Sarsekbayev",26,Kazakhstan,2008,Boxing,1,0,0,1
"Yerkebulan Shynaliyev",20,Kazakhstan,2008,Boxing,0,0,1,1
"Vijender Singh",22,India,2008,Boxing,0,0,1,1
"Daouda Sow",25,France,2008,Boxing,0,1,0,1
"Darren Sutherland",26,Ireland,2008,Boxing,0,0,1,1
"Aleksey Tishchenko",24,Russia,2008,Boxing,1,0,0,1
"Yordenis Ugás",22,Cuba,2008,Boxing,0,0,1,1
"Alexis Vastine",21,France,2008,Boxing,0,0,1,1
"Deontay Wilder",22,"United States",2008,Boxing,0,0,1,1
"Zhang Xiaoping",26,China,2008,Boxing,1,0,0,1
"Zhang Zhilei",25,China,2008,Boxing,0,1,0,1
"Zou Shiming",27,China,2008,Boxing,1,0,0,1
"Phil Dalhausser",28,"United States",2008,"Beach Volleyball",1,0,0,1
Emanuel,35,Brazil,2008,"Beach Volleyball",0,0,1,1
Fábio,29,Brazil,2008,"Beach Volleyball",0,1,0,1
Márcio,34,Brazil,2008,"Beach Volleyball",0,1,0,1
"Misty May-Treanor",31,"United States",2008,"Beach Volleyball",1,0,0,1
Ricardo,33,Brazil,2008,"Beach Volleyball",0,0,1,1
"Todd Rogers",34,"United States",2008,"Beach Volleyball",1,0,0,1
"Tian Jia",27,China,2008,"Beach Volleyball",0,1,0,1
"Kerri Walsh",29,"United States",2008,"Beach Volleyball",1,0,0,1
"Wang Jie",24,China,2008,"Beach Volleyball",0,1,0,1
"Xue Chen",19,China,2008,"Beach Volleyball",0,0,1,1
"Zhang Xi",23,China,2008,"Beach Volleyball",0,0,1,1
"Svetlana Abrosimova",28,Russia,2008,Basketball,0,0,1,1
"Carmelo Anthony",24,"United States",2008,Basketball,1,0,0,1
"Seimone Augustus",24,"United States",2008,Basketball,1,0,0,1
"Suzy Batkovic",27,Australia,2008,Basketball,0,1,0,1
"Tully Bevilaqua",36,Australia,2008,Basketball,0,1,0,1
"Sue Bird",27,"United States",2008,Basketball,1,0,0,1
"Carlos Boozer",26,"United States",2008,Basketball,1,0,0,1
"Chris Bosh",24,"United States",2008,Basketball,1,0,0,1
"Kobe Bryant",29,"United States",2008,Basketball,1,0,0,1
"José Manuel Calderón",26,Spain,2008,Basketball,0,1,0,1
"Tamika Catchings",29,"United States",2008,Basketball,1,0,0,1
"Rohanee Cox",27,Australia,2008,Basketball,0,1,0,1
"Carlos Delfino",25,Argentina,2008,Basketball,0,0,1,1
"Rudy Fernández",23,Spain,2008,Basketball,0,1,0,1
"Sylvia Fowles",22,"United States",2008,Basketball,1,0,0,1
"Jorge Garbajosa",30,Spain,2008,Basketball,0,1,0,1
"Marc Gasol",23,Spain,2008,Basketball,0,1,0,1
"Pau Gasol",28,Spain,2008,Basketball,0,1,0,1
"Manu Ginóbili",31,Argentina,2008,Basketball,0,0,1,1
"Román González",30,Argentina,2008,Basketball,0,0,1,1
"Hollie Grima",24,Australia,2008,Basketball,0,1,0,1
"Juan Pedro Gutiérrez",24,Argentina,2008,Basketball,0,0,1,1
"Leonardo Gutiérrez",30,Argentina,2008,Basketball,0,0,1,1
"Becky Hammon",31,Russia,2008,Basketball,0,0,1,1
"Kristi Harrower",33,Australia,2008,Basketball,0,1,0,1
"Dwight Howard",22,"United States",2008,Basketball,1,0,0,1
"Lauren Jackson",27,Australia,2008,Basketball,0,1,0,1
"LeBron James",23,"United States",2008,Basketball,1,0,0,1
"Carlos Jiménez",32,Spain,2008,Basketball,0,1,0,1
"Federico Kammerichs",28,Argentina,2008,Basketball,0,0,1,1
"Marina Karpunina",24,Russia,2008,Basketball,0,0,1,1
"Jason Kidd",35,"United States",2008,Basketball,1,0,0,1
"Ilona Korstin",28,Russia,2008,Basketball,0,0,1,1
"Marina Kuzina",23,Russia,2008,Basketball,0,0,1,1
"Kara Lawson",27,"United States",2008,Basketball,1,0,0,1
"Lisa Leslie",36,"United States",2008,Basketball,1,0,0,1
"Yekaterina Lisina",20,Russia,2008,Basketball,0,0,1,1
"Raúl López",28,Spain,2008,Basketball,0,1,0,1
"DeLisha Milton-Jones",33,"United States",2008,Basketball,1,0,0,1
"Álex Mumbrú",29,Spain,2008,Basketball,0,1,0,1
"Juan Carlos Navarro",28,Spain,2008,Basketball,0,1,0,1
"Andrés Nocioni",28,Argentina,2008,Basketball,0,0,1,1
"Fabricio Oberto",35,Argentina,2008,Basketball,0,0,1,1
"Irina Osipova",27,Russia,2008,Basketball,0,0,1,1
"Candace Parker",22,"United States",2008,Basketball,1,0,0,1
"Chris Paul",23,"United States",2008,Basketball,1,0,0,1
"Erin Phillips",23,Australia,2008,Basketball,0,1,0,1
"Cappie Pondexter",25,"United States",2008,Basketball,1,0,0,1
"Antonio Porta",24,Argentina,2008,Basketball,0,0,1,1
"Pablo Prigioni",31,Argentina,2008,Basketball,0,0,1,1
"Tayshaun Prince",28,"United States",2008,Basketball,1,0,0,1
"Paolo Quinteros",29,Argentina,2008,Basketball,0,0,1,1
"Oksana Rakhmatulina",31,Russia,2008,Basketball,0,0,1,1
"Emma Randall",23,Australia,2008,Basketball,0,1,0,1
"Michael Redd",28,"United States",2008,Basketball,1,0,0,1
"Felipe Reyes",28,Spain,2008,Basketball,0,1,0,1
"Berni Rodríguez",28,Spain,2008,Basketball,0,1,0,1
"Ricky Rubio",17,Spain,2008,Basketball,0,1,0,1
"Luis Scola",28,Argentina,2008,Basketball,0,0,1,1
"Jenni Screen",26,Australia,2008,Basketball,0,1,0,1
"Tatyana Shchyegoleva",26,Russia,2008,Basketball,0,0,1,1
"Katie Smith",34,"United States",2008,Basketball,1,0,0,1
"Belinda Snell",27,Australia,2008,Basketball,0,1,0,1
"Irina Sokolovskaya",25,Russia,2008,Basketball,0,0,1,1
"Mariya Stepanova",29,Russia,2008,Basketball,0,0,1,1
"Laura Summerton-Hodges",24,Australia,2008,Basketball,0,1,0,1
"Diana Taurasi",26,"United States",2008,Basketball,1,0,0,1
"Penny Taylor",27,Australia,2008,Basketball,0,1,0,1
"Tina Thompson",33,"United States",2008,Basketball,1,0,0,1
"Nataliya Vodopyanova",27,Russia,2008,Basketball,0,0,1,1
"Dwyane Wade Jr.",26,"United States",2008,Basketball,1,0,0,1
"Deron Williams",24,"United States",2008,Basketball,1,0,0,1
"Cai Yun",28,China,2008,Badminton,0,1,0,1
"Chen Jin",22,China,2008,Badminton,0,0,1,1
"Du Jing",24,China,2008,Badminton,1,0,0,1
"Fu Haifeng",24,China,2008,Badminton,0,1,0,1
"He Hanbin",22,China,2008,Badminton,0,0,1,1
"Hwang Ji-Man",24,"South Korea",2008,Badminton,0,0,1,1
"Markis Kido",24,Indonesia,2008,Badminton,1,0,0,1
"Lee Chong Wei",25,Malaysia,2008,Badminton,0,1,0,1
"Lee Gyeong-Won",28,"South Korea",2008,Badminton,0,1,0,1
"Lee Jae-Jin",25,"South Korea",2008,Badminton,0,0,1,1
"Lee Yong-Dae",19,"South Korea",2008,Badminton,1,0,0,1
"Lin Dan",24,China,2008,Badminton,1,0,0,1
"Lilyana Natsir",22,Indonesia,2008,Badminton,0,1,0,1
"Hendra Setiawan",23,Indonesia,2008,Badminton,1,0,0,1
"Wei Yili",26,China,2008,Badminton,0,0,1,1
"Nova Widianto",30,Indonesia,2008,Badminton,0,1,0,1
"Xie Xingfan",27,China,2008,Badminton,0,1,0,1
"Maria Yulianti",23,Indonesia,2008,Badminton,0,0,1,1
"Zhang Ning",33,China,2008,Badminton,1,0,0,1
"Zhang Yawen",23,China,2008,Badminton,0,0,1,1
"Mariya Abakumova",22,Russia,2008,Athletics,0,1,0,1
"Valerie Adams-Vili",23,"New Zealand",2008,Athletics,1,0,0,1
"Virgilijus Alekna",36,Lithuania,2008,Athletics,0,0,1,1
"Denis Alekseyev",20,Russia,2008,Athletics,0,0,1,1
"Olena Antonova",36,Ukraine,2008,Athletics,0,0,1,1
"Aaron Armstrong",30,"Trinidad and Tobago",2008,Athletics,0,1,0,1
"Nobuharu Asahara",36,Japan,2008,Athletics,0,0,1,1
"Mehdi Baala",29,France,2008,Athletics,0,0,1,1
"Dretti Bain",22,Bahamas,2008,Athletics,0,1,0,1
"Yarelis Barrios",25,Cuba,2008,Athletics,0,1,0,1
"Hasna Benhassi",30,Morocco,2008,Athletics,0,0,1,1
"Keston Bledman",20,"Trinidad and Tobago",2008,Athletics,0,1,0,1
"Valeriy Borchin",21,Russia,2008,Athletics,1,0,0,1
"Olivia Borlée",22,Belgium,2008,Athletics,0,1,0,1
"Chris Brown",29,Bahamas,2008,Athletics,0,1,0,1
"Stephanie Brown-Trafton",28,"United States",2008,Athletics,1,0,0,1
"Wilfred Bungei",28,Kenya,2008,Athletics,1,0,0,1
"Marc Burns",25,"Trinidad and Tobago",2008,Athletics,0,1,0,1
"Emmanuel Callender",24,"Trinidad and Tobago",2008,Athletics,0,1,0,1
"Ibrahim Camejo",26,Cuba,2008,Athletics,0,0,1,1
"Veronica Campbell-Brown",26,Jamaica,2008,Athletics,1,0,0,1
"Christian Cantwell",27,"United States",2008,Athletics,0,1,0,1
"Nesta Carter",22,Jamaica,2008,Athletics,1,0,0,1
"Yuliya Chermoshanskaya",22,Russia,2008,Athletics,1,0,0,1
"Tatyana Chernova",20,Russia,2008,Athletics,0,0,1,1
"Anna Chicherova",26,Russia,2008,Athletics,0,0,1,1
"Bryan Clay",28,"United States",2008,Athletics,1,0,0,1
"Shawn Crawford",30,"United States",2008,Athletics,0,1,0,1
"Tasha Danvers",30,"Great Britain",2008,Athletics,0,0,1,1
"Meseret Defar",24,Ethiopia,2008,Athletics,0,0,1,1
"Pigi Devetzi",32,Greece,2008,Athletics,0,0,1,1
"Vadim Devyatovsky",31,Belarus,2008,Athletics,0,1,0,1
"Constantina Dita-Tomescu",38,Romania,2008,Athletics,1,0,0,1
"Nataliya Dobrynska",26,Ukraine,2008,Athletics,1,0,0,1
"Maksim Dyldin",21,Russia,2008,Athletics,0,0,1,1
"Nelson Évora",24,Portugal,2008,Athletics,1,0,0,1
"Aleksandra Fedoriva",19,Russia,2008,Athletics,1,0,0,1
"Svetlana Feofanova",28,Russia,2008,Athletics,0,0,1,1
"Tatyana Firova",25,Russia,2008,Athletics,0,1,0,1
"Shalane Flanagan",27,"United States",2008,Athletics,0,0,1,1
"Hyleas Fountain",27,"United States",2008,Athletics,0,1,0,1
"Shelly-Ann Fraser-Pryce",21,Jamaica,2008,Athletics,1,0,0,1
"Michael Frater",25,Jamaica,2008,Athletics,1,0,0,1
"Vladislav Frolov",28,Russia,2008,Athletics,0,0,1,1
"Kim Gevaert",30,Belgium,2008,Athletics,0,1,0,1
"Jaouad Gharib",36,Morocco,2008,Athletics,0,1,0,1
"Dawn Harper",24,"United States",2008,Athletics,1,0,0,1
"Natasha Hastings",22,"United States",2008,Athletics,1,0,0,1
"Tia Hellebaut",30,Belgium,2008,Athletics,1,0,0,1
"Monique Henderson",25,"United States",2008,Athletics,1,0,0,1
"Steve Hooker",26,Australia,2008,Athletics,1,0,0,1
"Franca Idoko",23,Nigeria,2008,Athletics,0,0,1,1
"Phillips Idowu",29,"Great Britain",2008,Athletics,0,1,0,1
"Yelena Isinbayeva",26,Russia,2008,Athletics,1,0,0,1
"Ismail Ahmed Ismail",23,Sudan,2008,Athletics,0,1,0,1
"Halimat Ismaila",24,Nigeria,2008,Athletics,0,0,1,1
"Bershawn Jackson",25,"United States",2008,Athletics,0,0,1,1
"Pamela Jelimo",18,Kenya,2008,Athletics,1,0,0,1
"Eunice Jepkorir",26,Kenya,2008,Athletics,0,1,0,1
"Janeth Jepkosgei",24,Kenya,2008,Athletics,0,1,0,1
"Sheena Johnson-Tosta",25,"United States",2008,Athletics,0,1,0,1
"Olga Kaniskina",23,Russia,2008,Athletics,1,0,0,1
"Gerd Kanter",29,Estonia,2008,Athletics,1,0,0,1
"Anastasiya Kapachinskaya",28,Russia,2008,Athletics,0,1,0,1
"Tsegaye Kebede",21,Ethiopia,2008,Athletics,0,0,1,1
"Gloria Kemasoude",28,Nigeria,2008,Athletics,0,0,1,1
"Nataliya Khoronenko-Mikhnevich",26,Belarus,2008,Athletics,0,1,0,1
"Eliud Kipchoge",23,Kenya,2008,Athletics,0,1,0,1
"Asbel Kiprop",19,Kenya,2008,Athletics,1,0,0,1
"Brimin Kipruto",23,Kenya,2008,Athletics,1,0,0,1
"Micah Kogo",22,Kenya,2008,Athletics,0,0,1,1
"Anton Kokorin",21,Russia,2008,Athletics,0,0,1,1
"Ainars Kovals",26,Latvia,2008,Athletics,0,1,0,1
"Primož Kozmus",28,Slovenia,2008,Athletics,1,0,0,1
"Andrey Kravchenko",22,Belarus,2008,Athletics,0,1,0,1
"Nancy Langat",26,Kenya,2008,Athletics,1,0,0,1
"Iryna Lishchynska",32,Ukraine,2008,Athletics,0,1,0,1
"Lyudmila Litvinova",23,Russia,2008,Athletics,0,1,0,1
"Shereefa Lloyd",25,Jamaica,2008,Athletics,0,0,1,1
"Priscilla Lopes-Schliep",25,Canada,2008,Athletics,0,0,1,1
"Yevgeniy Lukyanenko",23,Russia,2008,Athletics,0,1,0,1
"Maurren Maggi",32,Brazil,2008,Athletics,1,0,0,1
"Tomasz Majewski",26,Poland,2008,Athletics,1,0,0,1
"Hanna Mariën",26,Belgium,2008,Athletics,0,1,0,1
"Germaine Mason",25,"Great Britain",2008,Athletics,0,1,0,1
"Richard Mateelong",24,Kenya,2008,Athletics,0,0,1,1
"Michael Mathieu",24,Bahamas,2008,Athletics,0,1,0,1
"Piotr Malachowski",25,Poland,2008,Athletics,0,1,0,1
"Françoise Mbango",32,Cameroon,2008,Athletics,1,0,0,1
"Sally McLellan-Pearson",21,Australia,2008,Athletics,0,1,0,1
"Mahiedine Mekhissi-Benabbad",23,France,2008,Athletics,0,1,0,1
"Oksana Menkova",26,Belarus,2008,Athletics,1,0,0,1
"Yelena Migunova",24,Russia,2008,Athletics,0,1,0,1
"Andrey Mikhnevich",32,Belarus,2008,Athletics,0,0,1,1
"Ramon Miller",21,Bahamas,2008,Athletics,0,1,0,1
"Godfrey Khotso Mokoena",23,"South Africa",2008,Athletics,0,1,0,1
"Avard Moncur",29,Bahamas,2008,Athletics,0,1,0,1
"Yipsi Moreno",27,Cuba,2008,Athletics,0,1,0,1
"Catherine Ndereba",36,Kenya,2008,Athletics,0,1,0,1
"Denis Nizhegorodov",28,Russia,2008,Athletics,0,0,1,1
"Christina Obergföll",26,Germany,2008,Athletics,0,0,1,1
"Christine Ohuruogu",24,"Great Britain",2008,Athletics,1,0,0,1
"Blessing Okagbare",19,Nigeria,2008,Athletics,0,0,1,1
"David Oliver",26,"United States",2008,Athletics,0,0,1,1
"Damola Osayomi",22,Nigeria,2008,Athletics,0,0,1,1
"Agnes Osazuwa",19,Nigeria,2008,Athletics,0,0,1,1
"Nadezhda Ostapchuk",27,Belarus,2008,Athletics,0,0,1,1
"Élodie Ouédraogo",27,Belgium,2008,Athletics,0,1,0,1
"David Payne",26,"United States",2008,Athletics,0,1,0,1
"Jefferson Pérez",34,Ecuador,2008,Athletics,0,1,0,1
"Tero Pitkämäki",25,Finland,2008,Athletics,0,0,1,1
"Yevgeniya Polyakova",25,Russia,2008,Athletics,1,0,0,1
"Asafa Powell",25,Jamaica,2008,Athletics,1,0,0,1
"Elisa Rigaudo",28,Italy,2008,Athletics,0,0,1,1
"Dayron Robles",21,Cuba,2008,Athletics,1,0,0,1
"Yaroslav Rybakov",27,Russia,2008,Athletics,0,0,1,1
"Irving Saladino",25,Panama,2008,Athletics,1,0,0,1
"Gulnara Samitova-Galkina",30,Russia,2008,Athletics,1,0,0,1
"Leevan Sands",27,Bahamas,2008,Athletics,0,0,1,1
"Alex Schwazer",23,Italy,2008,Athletics,1,0,0,1
"Sileshi Sihine",25,Ethiopia,2008,Athletics,0,1,0,1
"Andrey Silnov",23,Russia,2008,Athletics,1,0,0,1
"Sherone Simpson",24,Jamaica,2008,Athletics,0,1,0,1
"Edwin Soi",22,Kenya,2008,Athletics,0,0,1,1
"Barbora Špotáková",27,"Czech Republic",2008,Athletics,1,0,0,1
"Jenn Stuczynski-Suhr",26,"United States",2008,Athletics,0,1,0,1
"Leonel Suárez",20,Cuba,2008,Athletics,0,0,1,1
"Shingo Suetsugu",28,Japan,2008,Athletics,0,0,1,1
"Shinji Takahira",24,Japan,2008,Athletics,0,0,1,1
"Dwight Thomas",27,Jamaica,2008,Athletics,1,0,0,1
"Andreas Thorkildsen",26,Norway,2008,Athletics,1,0,0,1
"Ivan Tikhon",32,Belarus,2008,Athletics,0,0,1,1
"Nataliya Tobias",27,Ukraine,2008,Athletics,0,0,1,1
"Naoki Tsukahara",23,Japan,2008,Athletics,0,0,1,1
"Kjersti Tysse-Plätzer",36,Norway,2008,Athletics,0,1,0,1
"Tatyana Veshkurova",26,Russia,2008,Athletics,0,1,0,1
"Blanka Vlašic",24,Croatia,2008,Athletics,0,1,0,1
"Yekaterina Volkova",30,Russia,2008,Athletics,0,0,1,1
"Melaine Walker",25,Jamaica,2008,Athletics,1,0,0,1
"Sammy Wanjiru",21,Kenya,2008,Athletics,1,0,0,1
"Rosemarie Whyte",21,Jamaica,2008,Athletics,0,0,1,1
"Bobby-Gaye Wilkins",19,Jamaica,2008,Athletics,0,0,1,1
"Andrae Williams",25,Bahamas,2008,Athletics,0,1,0,1
"Novlene Williams-Mills",26,Jamaica,2008,Athletics,0,0,1,1
"Nick Willis",25,"New Zealand",2008,Athletics,0,1,0,1
"Mary Wineberg",28,"United States",2008,Athletics,1,0,0,1
"Regi Witherspoon",23,"United States",2008,Athletics,1,0,0,1
"Alfred Kirwa Yego",21,Kenya,2008,Athletics,0,0,1,1
"Denys Yurchenko",30,Ukraine,2008,Athletics,0,0,1,1
"Zhang Wenxiu",32,China,2008,Athletics,0,0,1,1
"Zhou Chunxiu",29,China,2008,Athletics,0,0,1,1
"Virginie Arnold",28,France,2008,Archery,0,0,1,1
"Bair Badyonov",32,Russia,2008,Archery,0,0,1,1
"Chen Ling",21,China,2008,Archery,0,1,0,1
"Ilario Di Buò",51,Italy,2008,Archery,0,1,0,1
"Sophie Dodémont",34,France,2008,Archery,0,0,1,1
"Marco Galiazzo",25,Italy,2008,Archery,0,1,0,1
"Guo Dan",22,China,2008,Archery,0,1,0,1
"Im Dong-Hyeon",23,"South Korea",2008,Archery,1,0,0,1
"Jiang Lin",26,China,2008,Archery,0,0,1,1
"Joo Hyun-Jung",26,"South Korea",2008,Archery,1,0,0,1
"Lee Chang-Hwan",26,"South Korea",2008,Archery,1,0,0,1
"Li Wenquan",22,China,2008,Archery,0,0,1,1
"Mauro Nespoli",20,Italy,2008,Archery,0,1,0,1
"Viktor Ruban",27,Ukraine,2008,Archery,1,0,0,1
"Bérengère Schuh",24,France,2008,Archery,0,0,1,1
"Xue Haifeng",28,China,2008,Archery,0,0,1,1
